date,ethnicity,active,recovered,deceased,total
2020-11-05,Māori,0,176,5,181
2020-11-05,Pacific peoples,1,183,1,185
2020-11-05,Asian,8,332,0,340
2020-11-05,"Middle Eastern, Latin American and African (MELAA)",4,59,1,64
2020-11-05,European or Other,54,1123,18,1195
2020-11-05,Total,67,1881,25,1973
2020-11-12,Māori,0,176,5,181
2020-11-12,Pacific peoples,1,183,1,185
2020-11-12,Asian,14,332,0,346
2020-11-12,"Middle Eastern, Latin American and African (MELAA)",4,59,1,64
2020-11-12,European or Other,33,1155,18,1206
2020-11-12,Total,53,1913,25,1991
2020-11-26,Māori,4,179,5,188
2020-11-26,Pacific peoples,2,182,1,185
2020-11-26,Asian,13,342,0,355
2020-11-26,"Middle Eastern, Latin American and African (MELAA)",4,62,1,67
2020-11-26,European or Other,37,1182,18,1237
2020-11-26,Total,60,1955,25,2040
2020-12-02,Māori,5,180,5,190
2020-12-02,Pacific peoples,2,181,1,184
2020-12-02,Asian,18,346,0,364
2020-12-02,"Middle Eastern, Latin American and African (MELAA)",7,62,1,70
2020-12-02,European or Other,39,1186,18,1243
2020-12-02,Total,72,1963,25,2060
2020-12-09,Māori,3,182,5,190
2020-12-09,Pacific peoples,1,182,1,184
2020-12-09,Asian,5,361,0,366
2020-12-09,"Middle Eastern, Latin American and African (MELAA)",8,63,1,72
2020-12-09,European or Other,33,1212,18,1263
2020-12-09,Total,55,2008,25,2088
2020-12-31,Māori,0,186,5,191
2020-12-31,Pacific peoples,1,182,1,184
2020-12-31,Asian,19,366,0,385
2020-12-31,"Middle Eastern, Latin American and African (MELAA)",3,72,1,76
2020-12-31,European or Other,29,1266,18,1313
2020-12-31,Unknown,3,10,0,13
2020-12-31,Total,55,2082,25,2162
2021-01-10,Māori,2,186,5,193
2021-01-10,Pacific peoples,1,182,1,184
2021-01-10,Asian,16,379,0,395
2021-01-10,"Middle Eastern, Latin American and African (MELAA)",1,74,1,76
2021-01-10,European or Other,53,1288,18,1359
2021-01-10,Unknown,2,10,0,12
2021-01-10,Total,75,2119,25,2219
2021-01-13,Māori,1,188,5,194
2021-01-13,Pacific peoples,1,182,1,184
2021-01-13,Asian,14,383,0,397
2021-01-13,"Middle Eastern, Latin American and African (MELAA)",1,74,1,76
2021-01-13,European or Other,45,1304,18,1367
2021-01-13,Unknown,0,10,0,10
2021-01-13,Total,62,2141,25,2228
2021-01-24,Māori,4,188,5,197
2021-01-24,Pacific peoples,2,182,1,185
2021-01-24,Asian,21,389,0,410
2021-01-24,"Middle Eastern, Latin American and African (MELAA)",9,74,1,84
2021-01-24,European or Other,40,1335,18,1393
2021-01-24,Unknown,3,11,0,14
2021-01-24,Total,79,2179,25,2283
2021-01-25,Māori,3,189,5,197
2021-01-25,Pacific peoples,2,182,1,185
2021-01-25,Asian,19,395,0,414
2021-01-25,"Middle Eastern, Latin American and African (MELAA)",8,75,1,84
2021-01-25,European or Other,29,1347,18,1394
2021-01-25,Unknown,3,11,0,14
2021-01-25,Total,64,2199,25,2288
2021-02-04,Māori,1,191,5,197
2021-02-04,Pacific peoples,3,182,1,186
2021-02-04,Asian,24,398,0,422
2021-02-04,"Middle Eastern, Latin American and African (MELAA)",6,80,1,87
2021-02-04,European or Other,24,1367,18,1409
2021-02-04,Unknown,2,10,0,12
2021-02-04,Total,60,2228,25,2313
2021-02-18,Māori,2,190,5,197
2021-02-18,Pacific peoples,3,185,1,189
2021-02-18,Asian,20,417,0,437
2021-02-18,"Middle Eastern, Latin American and African (MELAA)",6,83,2,91
2021-02-18,European or Other,14,1387,18,1419
2021-02-18,Unknown,1,10,0,11
2021-02-18,Total,46,2272,26,2344
2021-02-21,Māori,2,190,5,197
2021-02-21,Pacific peoples,3,185,1,189
2021-02-21,Asian,22,417,0,439
2021-02-21,"Middle Eastern, Latin American and African (MELAA)",8,83,2,93
2021-02-21,European or Other,15,1388,18,1421
2021-02-21,Unknown,1,10,0,11
2021-02-21,Total,51,2273,26,2350
2021-02-22,Māori,2,190,5,197
2021-02-22,Pacific peoples,3,185,1,189
2021-02-22,Asian,23,417,0,440
2021-02-22,"Middle Eastern, Latin American and African (MELAA)",9,84,2,95
2021-02-22,European or Other,16,1391,18,1425
2021-02-22,Unknown,1,10,0,11
2021-02-22,Total,54,2277,26,2357
2021-02-28,Māori,1,191,5,197
2021-02-28,Pacific peoples,3,185,1,189
2021-02-28,Asian,31,420,0,451
2021-02-28,"Middle Eastern, Latin American and African (MELAA)",9,88,2,99
2021-02-28,European or Other,18,1391,18,1427
2021-02-28,Unknown,3,10,0,13
2021-02-28,Total,65,2285,26,2376
2021-03-01,Māori,1,191,5,197
2021-03-01,Pacific peoples,3,185,1,189
2021-03-01,Asian,32,420,0,452
2021-03-01,"Middle Eastern, Latin American and African (MELAA)",9,88,2,99
2021-03-01,European or Other,18,1391,18,1427
2021-03-01,Unknown,4,10,0,14
2021-03-01,Total,67,2285,26,2378
2021-03-02,Māori,1,191,5,197
2021-03-02,Pacific peoples,3,185,1,189
2021-03-02,Asian,33,422,0,455
2021-03-02,"Middle Eastern, Latin American and African (MELAA)",12,88,2,102
2021-03-02,European or Other,18,1391,18,1427
2021-03-02,Unknown,2,10,0,12
2021-03-02,Total,69,2287,26,2382
2021-03-03,Māori,1,191,5,197
2021-03-03,Pacific peoples,2,186,1,189
2021-03-03,Asian,28,428,0,456
2021-03-03,"Middle Eastern, Latin American and African (MELAA)",12,88,2,102
2021-03-03,European or Other,17,1393,18,1428
2021-03-03,Unknown,2,10,0,12
2021-03-03,Total,62,2296,26,2384
2021-03-08,Māori,3,191,5,199
2021-03-08,Pacific peoples,2,186,1,189
2021-03-08,Asian,39,433,0,472
2021-03-08,"Middle Eastern, Latin American and African (MELAA)",13,88,2,103
2021-03-08,European or Other,19,1393,18,1430
2021-03-08,Unknown,2,10,0,12
2021-03-08,Total,78,2301,26,2405
2021-04-19,Māori,1,197,5,203
2021-04-19,Pacific peoples,2,190,1,193
2021-04-19,Asian,78,534,0,612
2021-04-19,"Middle Eastern, Latin American and African (MELAA)",11,103,2,116
2021-04-19,European or Other,10,1431,18,1459
2021-04-19,Unknown,0,13,0,13
2021-04-19,Total,102,2468,26,2596
2021-05-24,Māori,0,203,5,208
2021-05-24,Pacific peoples,0,198,1,199
2021-05-24,Asian,16,634,0,650
2021-05-24,"Middle Eastern, Latin American and African (MELAA)",2,121,2,125
2021-05-24,European or Other,5,1448,18,1471
2021-05-24,Unknown,1,13,0,14
2021-05-24,Total,24,2617,26,2667
2021-06-13,Māori,1,203,5,209
2021-06-13,Pacific peoples,0,199,1,200
2021-06-13,Asian,14,659,0,673
2021-06-13,"Middle Eastern, Latin American and African (MELAA)",7,124,2,133
2021-06-13,European or Other,5,1457,18,1480
2021-06-13,Unknown,0,13,0,13
2021-06-13,Total,27,2655,26,2708
2021-06-29,Māori,1,204,5,210
2021-06-29,Pacific peoples,0,199,1,200
2021-06-29,Asian,12,674,0,686
2021-06-29,"Middle Eastern, Latin American and African (MELAA)",0,131,2,133
2021-06-29,European or Other,11,1464,18,1493
2021-06-29,Unknown,6,13,0,19
2021-06-29,Total,30,2685,26,2741
2021-07-26,Māori,1,205,5,211
2021-07-26,Pacific peoples,6,200,1,207
2021-07-26,Asian,30,732,0,762
2021-07-26,"Middle Eastern, Latin American and African (MELAA)",6,134,2,142
2021-07-26,European or Other,9,1497,18,1524
2021-07-26,Unknown,2,15,0,17
2021-07-26,Total,54,2783,26,2863
2021-08-19,Māori,0,205,5,210
2021-08-19,Pacific peoples,12,206,1,219
2021-08-19,Asian,14,782,0,796
2021-08-19,"Middle Eastern, Latin American and African (MELAA)",9,142,2,153
2021-08-19,European or Other,14,1522,18,1554
2021-08-19,Unknown,6,16,0,22
2021-08-19,Total,55,2873,26,2954
2021-08-20,Māori,1,205,5,211
2021-08-20,Pacific peoples,22,206,1,229
2021-08-20,Asian,17,782,0,799
2021-08-20,"Middle Eastern, Latin American and African (MELAA)",9,142,2,153
2021-08-20,European or Other,16,1522,18,1556
2021-08-20,Unknown,4,16,0,20
2021-08-20,Total,69,2873,26,2968
2021-08-21,Māori,0,205,5,210
2021-08-21,Pacific peoples,40,206,1,247
2021-08-21,Asian,19,782,0,801
2021-08-21,"Middle Eastern, Latin American and African (MELAA)",10,142,2,154
2021-08-21,European or Other,20,1522,18,1560
2021-08-21,Unknown,4,16,0,20
2021-08-21,Total,93,2873,26,2992
2021-08-22,Māori,0,205,5,210
2021-08-22,Pacific peoples,53,206,1,260
2021-08-22,Asian,21,782,0,803
2021-08-22,"Middle Eastern, Latin American and African (MELAA)",10,142,2,154
2021-08-22,European or Other,24,1523,18,1565
2021-08-22,Unknown,8,16,0,24
2021-08-22,Total,116,2874,26,3016
2021-08-23,Māori,1,205,5,211
2021-08-23,Pacific peoples,76,206,1,283
2021-08-23,Asian,26,782,0,808
2021-08-23,"Middle Eastern, Latin American and African (MELAA)",10,142,2,154
2021-08-23,European or Other,27,1523,18,1568
2021-08-23,Unknown,14,16,0,30
2021-08-23,Total,154,2874,26,3054
2021-08-24,Māori,1,205,5,211
2021-08-24,Pacific peoples,110,206,1,317
2021-08-24,Asian,24,787,0,811
2021-08-24,"Middle Eastern, Latin American and African (MELAA)",5,148,2,155
2021-08-24,European or Other,36,1523,18,1577
2021-08-24,Unknown,7,18,0,25
2021-08-24,Total,183,2887,26,3096
2021-08-25,Māori,4,205,5,214
2021-08-25,Pacific peoples,151,206,1,358
2021-08-25,Asian,31,787,0,818
2021-08-25,"Middle Eastern, Latin American and African (MELAA)",5,148,2,155
2021-08-25,European or Other,42,1523,18,1583
2021-08-25,Unknown,13,18,0,31
2021-08-25,Total,246,2887,26,3159
2021-08-26,Māori,6,205,5,216
2021-08-26,Pacific peoples,200,206,1,407
2021-08-26,Asian,39,787,0,826
2021-08-26,"Middle Eastern, Latin American and African (MELAA)",5,148,2,155
2021-08-26,European or Other,45,1523,18,1586
2021-08-26,Unknown,19,18,0,37
2021-08-26,Total,314,2887,26,3227
2021-08-28,Māori,14,205,5,224
2021-08-28,Pacific peoples,305,206,1,512
2021-08-28,Asian,55,787,0,842
2021-08-28,"Middle Eastern, Latin American and African (MELAA)",6,148,2,156
2021-08-28,European or Other,55,1523,18,1596
2021-08-28,Unknown,31,18,0,49
2021-08-28,Total,467,2887,26,3380
2021-08-29,Māori,19,205,5,229
2021-08-29,Pacific peoples,366,206,1,573
2021-08-29,Asian,65,787,0,852
2021-08-29,"Middle Eastern, Latin American and African (MELAA)",6,148,2,156
2021-08-29,European or Other,61,1523,18,1602
2021-08-29,Unknown,34,18,0,52
2021-08-29,Total,551,2887,26,3464
2021-08-30,Māori,25,205,5,235
2021-08-30,Pacific peoples,408,207,1,616
2021-08-30,Asian,67,788,0,855
2021-08-30,"Middle Eastern, Latin American and African (MELAA)",7,148,2,157
2021-08-30,European or Other,65,1524,18,1607
2021-08-30,Unknown,31,18,0,49
2021-08-30,Total,603,2890,26,3519
2021-08-31,Māori,36,205,5,246
2021-08-31,Pacific peoples,435,207,1,643
2021-08-31,Asian,74,790,0,864
2021-08-31,"Middle Eastern, Latin American and African (MELAA)",7,148,2,157
2021-08-31,European or Other,71,1524,18,1613
2021-08-31,Unknown,28,18,0,46
2021-08-31,Total,651,2892,26,3569
2021-09-01,Māori,40,205,5,250
2021-09-01,Pacific peoples,494,209,1,704
2021-09-01,Asian,76,790,0,866
2021-09-01,"Middle Eastern, Latin American and African (MELAA)",7,148,2,157
2021-09-01,European or Other,76,1525,18,1619
2021-09-01,Unknown,31,18,0,49
2021-09-01,Total,724,2895,26,3645
2021-09-02,Māori,47,205,5,257
2021-09-02,Pacific peoples,524,211,1,736
2021-09-02,Asian,77,792,0,869
2021-09-02,"Middle Eastern, Latin American and African (MELAA)",8,148,2,158
2021-09-02,European or Other,78,1527,18,1623
2021-09-02,Unknown,36,18,0,54
2021-09-02,Total,770,2901,26,3697
2021-09-03,Māori,52,206,5,263
2021-09-03,Pacific peoples,529,224,1,754
2021-09-03,Asian,78,801,0,879
2021-09-03,"Middle Eastern, Latin American and African (MELAA)",8,151,2,161
2021-09-03,European or Other,61,1544,18,1623
2021-09-03,Unknown,27,22,0,49
2021-09-03,Total,755,2948,26,3729
2021-09-04,Māori,53,207,5,265
2021-09-04,Pacific peoples,543,236,1,780
2021-09-04,Asian,74,811,0,885
2021-09-04,"Middle Eastern, Latin American and African (MELAA)",10,151,2,163
2021-09-04,European or Other,61,1550,18,1629
2021-09-04,Unknown,10,16,0,26
2021-09-04,Total,751,2971,26,3748
2021-09-05,Māori,52,207,6,265
2021-09-05,Pacific peoples,543,255,1,799
2021-09-05,Asian,73,816,0,889
2021-09-05,"Middle Eastern, Latin American and African (MELAA)",10,151,2,163
2021-09-05,European or Other,60,1553,18,1631
2021-09-05,Unknown,5,16,0,21
2021-09-05,Total,743,2998,27,3768
2021-09-06,Māori,53,209,6,268
2021-09-06,Pacific peoples,537,278,1,816
2021-09-06,Asian,69,821,0,890
2021-09-06,"Middle Eastern, Latin American and African (MELAA)",10,151,2,163
2021-09-06,European or Other,56,1560,18,1634
2021-09-06,Unknown,4,17,0,21
2021-09-06,Total,729,3036,27,3792
2021-09-07,Māori,51,212,6,269
2021-09-07,Pacific peoples,534,299,1,834
2021-09-07,Asian,68,822,0,890
2021-09-07,"Middle Eastern, Latin American and African (MELAA)",9,152,2,163
2021-09-07,European or Other,52,1564,18,1634
2021-09-07,Unknown,6,17,0,23
2021-09-07,Total,720,3066,27,3813
2021-09-08,Māori,50,214,6,270
2021-09-08,Pacific peoples,496,348,1,845
2021-09-08,Asian,51,842,0,893
2021-09-08,"Middle Eastern, Latin American and African (MELAA)",7,154,2,163
2021-09-08,European or Other,49,1569,18,1636
2021-09-08,Unknown,5,17,0,22
2021-09-08,Total,658,3144,27,3829
2021-09-09,Māori,47,217,6,270
2021-09-09,Pacific peoples,472,380,1,853
2021-09-09,Asian,49,846,0,895
2021-09-09,"Middle Eastern, Latin American and African (MELAA)",7,155,2,164
2021-09-09,European or Other,41,1578,18,1637
2021-09-09,Unknown,9,19,0,28
2021-09-09,Total,625,3195,27,3847
2021-09-10,Māori,44,222,6,272
2021-09-10,Pacific peoples,465,396,1,862
2021-09-10,Asian,50,849,0,899
2021-09-10,"Middle Eastern, Latin American and African (MELAA)",8,155,2,165
2021-09-10,European or Other,39,1580,18,1637
2021-09-10,Unknown,11,20,0,31
2021-09-10,Total,617,3222,27,3866
2021-09-11,Māori,56,222,6,284
2021-09-11,Pacific peoples,474,397,1,872
2021-09-11,Asian,51,850,0,901
2021-09-11,"Middle Eastern, Latin American and African (MELAA)",8,155,2,165
2021-09-11,European or Other,39,1580,18,1637
2021-09-11,Unknown,12,19,0,31
2021-09-11,Total,640,3223,27,3890
2021-09-13,Māori,69,225,6,300
2021-09-13,Pacific peoples,439,465,1,905
2021-09-13,Asian,53,855,0,908
2021-09-13,"Middle Eastern, Latin American and African (MELAA)",8,155,2,165
2021-09-13,European or Other,33,1588,18,1639
2021-09-13,Unknown,12,20,0,32
2021-09-13,Total,614,3308,27,3949
2021-09-14,Māori,76,227,6,309
2021-09-14,Pacific peoples,428,480,1,909
2021-09-14,Asian,51,862,0,913
2021-09-14,"Middle Eastern, Latin American and African (MELAA)",7,156,2,165
2021-09-14,European or Other,36,1588,18,1642
2021-09-14,Unknown,6,22,0,28
2021-09-14,Total,604,3335,27,3966
2021-09-17,Māori,90,234,6,330
2021-09-17,Pacific peoples,311,607,1,919
2021-09-17,Asian,42,880,0,922
2021-09-17,"Middle Eastern, Latin American and African (MELAA)",5,160,2,167
2021-09-17,European or Other,36,1595,18,1649
2021-09-17,Unknown,5,22,0,27
2021-09-17,Total,489,3498,27,4014
2021-09-18,Māori,88,241,6,335
2021-09-18,Pacific peoples,251,680,1,932
2021-09-18,Asian,39,884,0,923
2021-09-18,"Middle Eastern, Latin American and African (MELAA)",5,160,2,167
2021-09-18,European or Other,31,1603,18,1652
2021-09-18,Unknown,6,23,0,29
2021-09-18,Total,420,3591,27,4038
2021-09-19,Māori,90,253,6,349
2021-09-19,Pacific peoples,228,710,1,939
2021-09-19,Asian,38,887,0,925
2021-09-19,"Middle Eastern, Latin American and African (MELAA)",4,161,2,167
2021-09-19,European or Other,27,1606,18,1651
2021-09-19,Unknown,7,22,0,29
2021-09-19,Total,394,3639,27,4060
2021-09-21,Māori,91,265,6,362
2021-09-21,Pacific peoples,167,784,1,952
2021-09-21,Asian,26,900,0,926
2021-09-21,"Middle Eastern, Latin American and African (MELAA)",3,162,2,167
2021-09-21,European or Other,25,1612,18,1655
2021-09-21,Unknown,13,20,0,33
2021-09-21,Total,325,3743,27,4095
2021-09-22,Māori,95,269,6,370
2021-09-22,Pacific peoples,141,822,1,964
2021-09-22,Asian,23,904,0,927
2021-09-22,"Middle Eastern, Latin American and African (MELAA)",4,162,2,168
2021-09-22,European or Other,25,1615,18,1658
2021-09-22,Unknown,13,19,0,32
2021-09-22,Total,301,3791,27,4119
2021-09-23,Māori,95,274,6,375
2021-09-23,Pacific peoples,130,842,1,973
2021-09-23,Asian,21,907,0,928
2021-09-23,"Middle Eastern, Latin American and African (MELAA)",4,162,2,168
2021-09-23,European or Other,25,1615,18,1658
2021-09-23,Unknown,14,19,0,33
2021-09-23,Total,289,3819,27,4135
2021-09-24,Māori,80,289,6,375
2021-09-24,Pacific peoples,111,867,1,979
2021-09-24,Asian,20,909,0,929
2021-09-24,"Middle Eastern, Latin American and African (MELAA)",7,162,2,171
2021-09-24,European or Other,25,1615,18,1658
2021-09-24,Unknown,13,19,0,32
2021-09-24,Total,256,3861,27,4144
2021-09-25,Māori,73,300,6,379
2021-09-25,Pacific peoples,112,873,1,986
2021-09-25,Asian,20,913,0,933
2021-09-25,"Middle Eastern, Latin American and African (MELAA)",7,162,2,171
2021-09-25,European or Other,26,1618,18,1662
2021-09-25,Unknown,12,19,0,31
2021-09-25,Total,250,3885,27,4162
2021-09-26,Māori,78,303,6,387
2021-09-26,Pacific peoples,96,895,1,992
2021-09-26,Asian,13,921,0,934
2021-09-26,"Middle Eastern, Latin American and African (MELAA)",7,163,2,172
2021-09-26,European or Other,18,1630,18,1666
2021-09-26,Unknown,13,19,0,32
2021-09-26,Total,225,3931,27,4183
2021-09-27,Māori,76,310,6,392
2021-09-27,Pacific peoples,99,899,1,999
2021-09-27,Asian,12,922,0,934
2021-09-27,"Middle Eastern, Latin American and African (MELAA)",7,163,2,172
2021-09-27,European or Other,15,1632,18,1665
2021-09-27,Unknown,13,19,0,32
2021-09-27,Total,222,3945,27,4194
2021-09-28,Māori,75,317,6,398
2021-09-28,Pacific peoples,94,908,1,1003
2021-09-28,Asian,11,921,0,932
2021-09-28,"Middle Eastern, Latin American and African (MELAA)",8,163,2,173
2021-09-28,European or Other,18,1633,18,1669
2021-09-28,Unknown,10,19,0,29
2021-09-28,Total,216,3961,27,4204
2021-09-29,Māori,95,320,6,421
2021-09-29,Pacific peoples,113,909,1,1023
2021-09-29,Asian,13,921,0,934
2021-09-29,"Middle Eastern, Latin American and African (MELAA)",8,163,2,173
2021-09-29,European or Other,18,1633,18,1669
2021-09-29,Unknown,9,19,0,28
2021-09-29,Total,256,3965,27,4248
2021-09-30,Māori,100,324,6,430
2021-09-30,Pacific peoples,118,912,1,1031
2021-09-30,Asian,14,922,0,936
2021-09-30,"Middle Eastern, Latin American and African (MELAA)",9,163,2,174
2021-09-30,European or Other,20,1633,18,1671
2021-09-30,Unknown,11,20,0,31
2021-09-30,Total,272,3974,27,4273
2021-10-01,Māori,106,333,6,445
2021-10-01,Pacific peoples,117,917,1,1035
2021-10-01,Asian,17,922,0,939
2021-10-01,"Middle Eastern, Latin American and African (MELAA)",9,163,2,174
2021-10-01,European or Other,19,1634,18,1671
2021-10-01,Unknown,7,20,0,27
2021-10-01,Total,275,3989,27,4291
2021-10-02,Māori,90,359,6,455
2021-10-02,Pacific peoples,99,944,1,1044
2021-10-02,Asian,16,926,0,942
2021-10-02,"Middle Eastern, Latin American and African (MELAA)",7,165,2,174
2021-10-02,European or Other,20,1638,18,1676
2021-10-02,Unknown,7,21,0,28
2021-10-02,Total,239,4053,27,4319
2021-10-03,Māori,97,361,6,464
2021-10-03,Pacific peoples,103,950,1,1054
2021-10-03,Asian,23,927,0,950
2021-10-03,"Middle Eastern, Latin American and African (MELAA)",6,164,2,172
2021-10-03,European or Other,28,1638,18,1684
2021-10-03,Unknown,6,22,0,28
2021-10-03,Total,263,4062,27,4352
2021-10-04,Māori,107,364,6,477
2021-10-04,Pacific peoples,109,952,1,1062
2021-10-04,Asian,22,928,0,950
2021-10-04,"Middle Eastern, Latin American and African (MELAA)",6,164,2,172
2021-10-04,European or Other,36,1638,18,1692
2021-10-04,Unknown,7,22,0,29
2021-10-04,Total,287,4068,27,4382
2021-10-05,Māori,118,364,6,488
2021-10-05,Pacific peoples,111,953,1,1065
2021-10-05,Asian,26,928,0,954
2021-10-05,"Middle Eastern, Latin American and African (MELAA)",6,164,2,172
2021-10-05,European or Other,35,1642,18,1695
2021-10-05,Unknown,12,22,0,34
2021-10-05,Total,308,4073,27,4408
2021-10-06,Māori,136,364,6,506
2021-10-06,Pacific peoples,119,953,1,1073
2021-10-06,Asian,29,928,0,957
2021-10-06,"Middle Eastern, Latin American and African (MELAA)",6,164,2,172
2021-10-06,European or Other,46,1641,18,1705
2021-10-06,Unknown,14,23,0,37
2021-10-06,Total,350,4073,27,4450
2021-10-07,Māori,149,364,6,519
2021-10-07,Pacific peoples,125,953,1,1079
2021-10-07,Asian,27,930,0,957
2021-10-07,"Middle Eastern, Latin American and African (MELAA)",5,165,2,172
2021-10-07,European or Other,51,1642,18,1711
2021-10-07,Unknown,19,23,0,42
2021-10-07,Total,376,4077,27,4480
2021-10-08,Māori,174,365,6,545
2021-10-08,Pacific peoples,136,952,2,1090
2021-10-08,Asian,28,931,0,959
2021-10-08,"Middle Eastern, Latin American and African (MELAA)",5,165,2,172
2021-10-08,European or Other,66,1642,18,1726
2021-10-08,Unknown,13,22,0,35
2021-10-08,Total,422,4077,28,4527
2021-10-09,Māori,179,375,6,560
2021-10-09,Pacific peoples,118,972,2,1092
2021-10-09,Asian,27,936,0,963
2021-10-09,"Middle Eastern, Latin American and African (MELAA)",5,167,2,174
2021-10-09,European or Other,77,1644,18,1739
2021-10-09,Unknown,13,22,0,35
2021-10-09,Total,419,4116,28,4563
2021-10-10,Māori,199,385,6,590
2021-10-10,Pacific peoples,117,985,2,1104
2021-10-10,Asian,27,936,0,963
2021-10-10,"Middle Eastern, Latin American and African (MELAA)",5,167,2,174
2021-10-10,European or Other,94,1645,18,1757
2021-10-10,Unknown,14,22,0,36
2021-10-10,Total,456,4140,28,4624
2021-10-11,Māori,205,392,6,603
2021-10-11,Pacific peoples,114,996,2,1112
2021-10-11,Asian,27,937,0,964
2021-10-11,"Middle Eastern, Latin American and African (MELAA)",4,169,2,175
2021-10-11,European or Other,105,1646,18,1769
2021-10-11,Unknown,14,22,0,36
2021-10-11,Total,469,4162,28,4659
2021-10-12,Māori,219,397,6,622
2021-10-12,Pacific peoples,117,1004,2,1123
2021-10-12,Asian,27,940,0,967
2021-10-12,"Middle Eastern, Latin American and African (MELAA)",4,169,2,175
2021-10-12,European or Other,113,1649,18,1780
2021-10-12,Unknown,14,23,0,37
2021-10-12,Total,494,4182,28,4704
2021-10-13,Māori,246,397,6,649
2021-10-13,Pacific peoples,129,1004,2,1135
2021-10-13,Asian,30,940,0,970
2021-10-13,"Middle Eastern, Latin American and African (MELAA)",5,169,2,176
2021-10-13,European or Other,120,1651,18,1789
2021-10-13,Unknown,17,23,0,40
2021-10-13,Total,547,4184,28,4759
2021-10-14,Māori,282,398,6,686
2021-10-14,Pacific peoples,139,1004,2,1145
2021-10-14,Asian,31,940,0,971
2021-10-14,"Middle Eastern, Latin American and African (MELAA)",5,169,2,176
2021-10-14,European or Other,140,1652,18,1810
2021-10-14,Unknown,20,23,0,43
2021-10-14,Total,617,4186,28,4831
2021-10-15,Māori,305,398,6,709
2021-10-15,Pacific peoples,155,1004,2,1161
2021-10-15,Asian,36,940,0,976
2021-10-15,"Middle Eastern, Latin American and African (MELAA)",5,169,2,176
2021-10-15,European or Other,159,1652,18,1829
2021-10-15,Unknown,23,23,0,46
2021-10-15,Total,683,4186,28,4897
2021-10-16,Māori,289,428,6,723
2021-10-16,Pacific peoples,143,1024,2,1169
2021-10-16,Asian,34,943,0,977
2021-10-16,"Middle Eastern, Latin American and African (MELAA)",6,169,2,177
2021-10-16,European or Other,170,1659,18,1847
2021-10-16,Unknown,23,23,0,46
2021-10-16,Total,665,4246,28,4939
2021-10-17,Māori,274,462,6,742
2021-10-17,Pacific peoples,127,1050,2,1179
2021-10-17,Asian,34,946,0,980
2021-10-17,"Middle Eastern, Latin American and African (MELAA)",5,170,2,177
2021-10-17,European or Other,177,1670,18,1865
2021-10-17,Unknown,25,23,0,48
2021-10-17,Total,642,4321,28,4991
2021-10-18,Māori,291,476,6,773
2021-10-18,Pacific peoples,123,1062,2,1187
2021-10-18,Asian,28,958,0,986
2021-10-18,"Middle Eastern, Latin American and African (MELAA)",7,170,2,179
2021-10-18,European or Other,177,1681,18,1876
2021-10-18,Unknown,26,28,0,54
2021-10-18,Total,652,4375,28,5055
2021-10-19,Māori,323,483,6,812
2021-10-19,Pacific peoples,136,1064,2,1202
2021-10-19,Asian,32,959,0,991
2021-10-19,"Middle Eastern, Latin American and African (MELAA)",8,170,2,180
2021-10-19,European or Other,208,1689,18,1915
2021-10-19,Unknown,29,24,0,53
2021-10-19,Total,736,4389,28,5153
2021-10-20,Māori,348,486,6,840
2021-10-20,Pacific peoples,147,1064,2,1213
2021-10-20,Asian,33,959,0,992
2021-10-20,"Middle Eastern, Latin American and African (MELAA)",9,170,2,181
2021-10-20,European or Other,223,1693,18,1934
2021-10-20,Unknown,30,23,0,53
2021-10-20,Total,790,4395,28,5213
2021-10-21,Māori,394,486,6,886
2021-10-21,Pacific peoples,161,1065,2,1228
2021-10-21,Asian,38,959,0,997
2021-10-21,"Middle Eastern, Latin American and African (MELAA)",10,170,2,182
2021-10-21,European or Other,251,1694,18,1963
2021-10-21,Unknown,37,22,0,59
2021-10-21,Total,891,4396,28,5315
2021-10-22,Māori,445,487,6,938
2021-10-22,Pacific peoples,180,1065,2,1247
2021-10-22,Asian,41,960,0,1001
2021-10-22,"Middle Eastern, Latin American and African (MELAA)",16,170,2,188
2021-10-22,European or Other,300,1698,18,2016
2021-10-22,Unknown,37,22,0,59
2021-10-22,Total,1019,4402,28,5449
2021-10-23,Māori,488,489,6,983
2021-10-23,Pacific peoples,193,1065,2,1260
2021-10-23,Asian,44,962,0,1006
2021-10-23,"Middle Eastern, Latin American and African (MELAA)",18,170,2,190
2021-10-23,European or Other,334,1700,18,2052
2021-10-23,Unknown,42,21,0,63
2021-10-23,Total,1119,4407,28,5554
2021-10-25,Māori,543,518,6,1067
2021-10-25,Pacific peoples,213,1075,2,1290
2021-10-25,Asian,57,963,0,1020
2021-10-25,"Middle Eastern, Latin American and African (MELAA)",19,170,2,191
2021-10-25,European or Other,370,1719,18,2107
2021-10-25,Unknown,54,20,0,74
2021-10-25,Total,1256,4465,28,5749
2021-10-26,Māori,526,565,6,1097
2021-10-26,Pacific peoples,209,1097,2,1308
2021-10-26,Asian,57,967,0,1024
2021-10-26,"Middle Eastern, Latin American and African (MELAA)",21,172,2,195
2021-10-26,European or Other,374,1738,18,2130
2021-10-26,Unknown,45,23,0,68
2021-10-26,Total,1232,4562,28,5822
2021-10-27,Māori,565,566,6,1137
2021-10-27,Pacific peoples,215,1097,2,1314
2021-10-27,Asian,62,967,0,1029
2021-10-27,"Middle Eastern, Latin American and African (MELAA)",21,172,2,195
2021-10-27,European or Other,394,1739,18,2151
2021-10-27,Unknown,47,26,0,73
2021-10-27,Total,1304,4567,28,5899
2021-10-28,Māori,601,568,6,1175
2021-10-28,Pacific peoples,237,1097,2,1336
2021-10-28,Asian,66,968,0,1034
2021-10-28,"Middle Eastern, Latin American and African (MELAA)",23,172,2,197
2021-10-28,European or Other,414,1743,18,2175
2021-10-28,Unknown,52,26,0,78
2021-10-28,Total,1393,4574,28,5995
2021-10-29,Māori,641,569,6,1216
2021-10-29,Pacific peoples,273,1098,2,1373
2021-10-29,Asian,74,970,0,1044
2021-10-29,"Middle Eastern, Latin American and African (MELAA)",27,172,2,201
2021-10-29,European or Other,446,1745,18,2209
2021-10-29,Unknown,55,26,0,81
2021-10-29,Total,1516,4580,28,6124
2021-10-30,Māori,714,572,6,1292
2021-10-30,Pacific peoples,293,1099,2,1394
2021-10-30,Asian,85,970,0,1055
2021-10-30,"Middle Eastern, Latin American and African (MELAA)",29,172,2,203
2021-10-30,European or Other,493,1746,18,2257
2021-10-30,Unknown,58,26,0,84
2021-10-30,Total,1672,4585,28,6285
2021-10-31,Māori,759,596,6,1361
2021-10-31,Pacific peoples,308,1111,2,1421
2021-10-31,Asian,94,970,0,1064
2021-10-31,"Middle Eastern, Latin American and African (MELAA)",30,172,2,204
2021-10-31,European or Other,506,1769,18,2293
2021-10-31,Unknown,56,29,0,85
2021-10-31,Total,1753,4647,28,6428
2021-11-01,Māori,837,597,6,1440
2021-11-01,Pacific peoples,331,1111,2,1444
2021-11-01,Asian,96,971,0,1067
2021-11-01,"Middle Eastern, Latin American and African (MELAA)",33,172,2,207
2021-11-01,European or Other,557,1770,18,2345
2021-11-01,Unknown,62,29,0,91
2021-11-01,Total,1916,4650,28,6594
2021-11-02,Māori,845,639,6,1490
2021-11-02,Pacific peoples,346,1126,2,1474
2021-11-02,Asian,103,974,0,1077
2021-11-02,"Middle Eastern, Latin American and African (MELAA)",34,172,2,208
2021-11-02,European or Other,573,1788,18,2379
2021-11-02,Unknown,63,32,0,95
2021-11-02,Total,1964,4731,28,6723
2021-11-03,Māori,889,643,6,1538
2021-11-03,Pacific peoples,366,1128,2,1496
2021-11-03,Asian,110,974,0,1084
2021-11-03,"Middle Eastern, Latin American and African (MELAA)",34,172,2,208
2021-11-03,European or Other,598,1793,18,2409
2021-11-03,Unknown,65,32,0,97
2021-11-03,Total,2062,4742,28,6832
2021-11-05,Māori,1001,654,7,1662
2021-11-05,Pacific peoples,426,1129,2,1557
2021-11-05,Asian,136,975,0,1111
2021-11-05,"Middle Eastern, Latin American and African (MELAA)",38,172,2,212
2021-11-05,European or Other,662,1811,18,2491
2021-11-05,Unknown,73,32,0,105
2021-11-05,Total,2336,4773,29,7138
2021-11-11,Māori,1343,755,8,2106
2021-11-11,Pacific peoples,612,1163,2,1777
2021-11-11,Asian,184,992,1,1177
2021-11-11,"Middle Eastern, Latin American and African (MELAA)",59,173,2,234
2021-11-11,European or Other,824,1871,20,2715
2021-11-11,Unknown,69,29,0,98
2021-11-11,Total,3091,4983,33,8107
2021-11-15,Māori,69,176,2,247
2021-11-15,Pacific peoples,731,1207,2,1940
2021-11-15,Asian,71,29,0,100
2021-11-15,"Middle Eastern, Latin American and African (MELAA)",201,999,2,1202
2021-11-15,European or Other,899,1919,20,2838
2021-11-15,Unknown,1685,846,8,2539
2021-11-15,Total,3656,5176,34,8866
2021-11-17,Māori,1912,853,8,2773
2021-11-17,Pacific peoples,822,1209,2,2033
2021-11-17,Asian,217,999,2,1218
2021-11-17,"Middle Eastern, Latin American and African (MELAA)",73,177,2,252
2021-11-17,European or Other,953,1928,21,2902
2021-11-17,Unknown,74,33,0,107
2021-11-17,Total,4051,5199,35,9285
2021-11-18,Māori,1988,868,8,2864
2021-11-18,Pacific peoples,853,1212,2,2067
2021-11-18,Asian,222,999,2,1223
2021-11-18,"Middle Eastern, Latin American and African (MELAA)",74,178,2,254
2021-11-18,European or Other,964,1935,21,2920
2021-11-18,Unknown,91,33,0,124
2021-11-18,Total,4192,5225,35,9452
2021-11-20,Māori,2109,940,10,3059
2021-11-20,Pacific peoples,925,1236,3,2164
2021-11-20,Asian,241,1000,2,1243
2021-11-20,"Middle Eastern, Latin American and African (MELAA)",72,181,2,255
2021-11-20,European or Other,992,1970,22,2984
2021-11-20,Unknown,82,36,0,118
2021-11-20,Total,4421,5363,39,9823
2021-11-21,Māori,2108,1026,10,3144
2021-11-21,Pacific peoples,942,1258,3,2203
2021-11-21,Asian,244,1002,2,1248
2021-11-21,"Middle Eastern, Latin American and African (MELAA)",70,184,2,256
2021-11-21,European or Other,991,1988,22,3001
2021-11-21,Unknown,82,38,0,120
2021-11-21,Total,4437,5496,39,9972
2021-11-22,Māori,2211,1027,11,3249
2021-11-22,Pacific peoples,996,1258,3,2257
2021-11-22,Asian,255,1002,2,1259
2021-11-22,"Middle Eastern, Latin American and African (MELAA)",72,184,2,258
2021-11-22,European or Other,1021,1989,22,3032
2021-11-22,Unknown,83,38,0,121
2021-11-22,Total,4638,5498,40,10176
2021-11-23,Māori,2303,1043,11,3357
2021-11-23,Pacific peoples,1062,1259,3,2324
2021-11-23,Asian,264,1002,2,1268
2021-11-23,"Middle Eastern, Latin American and African (MELAA)",74,184,2,260
2021-11-23,European or Other,1029,1999,22,3050
2021-11-23,Unknown,96,38,0,134
2021-11-23,Total,4828,5525,40,10393
2021-11-24,Māori,2415,1045,11,3471
2021-11-24,Pacific peoples,1118,1261,3,2382
2021-11-24,Asian,280,1002,2,1284
2021-11-24,"Middle Eastern, Latin American and African (MELAA)",76,184,2,262
2021-11-24,European or Other,1055,2003,22,3080
2021-11-24,Unknown,92,38,0,130
2021-11-24,Total,5036,5533,40,10609
2021-11-25,Māori,2515,1047,12,3574
2021-11-25,Pacific peoples,1161,1261,3,2425
2021-11-25,Asian,285,1002,2,1289
2021-11-25,"Middle Eastern, Latin American and African (MELAA)",79,184,2,265
2021-11-25,European or Other,1074,2003,22,3099
2021-11-25,Unknown,99,38,0,137
2021-11-25,Total,5213,5535,41,10789
2021-11-26,Māori,2610,1053,12,3675
2021-11-26,Pacific peoples,1199,1264,3,2466
2021-11-26,Asian,293,1002,2,1297
2021-11-26,"Middle Eastern, Latin American and African (MELAA)",81,184,2,267
2021-11-26,European or Other,1092,2008,23,3123
2021-11-26,Unknown,100,38,0,138
2021-11-26,Total,5375,5549,42,10966
2021-11-27,Māori,2677,1061,12,3750
2021-11-27,Pacific peoples,1233,1265,3,2501
2021-11-27,Asian,307,1002,2,1311
2021-11-27,"Middle Eastern, Latin American and African (MELAA)",82,184,2,268
2021-11-27,European or Other,1100,2017,23,3140
2021-11-27,Unknown,106,38,0,144
2021-11-27,Total,5505,5567,42,11114
2021-11-28,Māori,2721,1098,12,3831
2021-11-28,Pacific peoples,1271,1266,3,2540
2021-11-28,Asian,309,1004,2,1315
2021-11-28,"Middle Eastern, Latin American and African (MELAA)",83,184,2,269
2021-11-28,European or Other,1091,2044,24,3159
2021-11-28,Unknown,107,39,0,146
2021-11-28,Total,5582,5635,43,11260
2021-11-29,Māori,2801,1107,12,3920
2021-11-29,Pacific peoples,1330,1266,3,2599
2021-11-29,Asian,321,1004,2,1327
2021-11-29,"Middle Eastern, Latin American and African (MELAA)",86,185,2,273
2021-11-29,European or Other,1110,2044,24,3178
2021-11-29,Unknown,108,39,0,147
2021-11-29,Total,5756,5645,43,11444
2021-11-30,Māori,2862,1112,12,3986
2021-11-30,Pacific peoples,1363,1268,4,2635
2021-11-30,Asian,329,1004,2,1335
2021-11-30,"Middle Eastern, Latin American and African (MELAA)",86,185,2,273
2021-11-30,European or Other,1126,2046,24,3196
2021-11-30,Unknown,112,39,0,151
2021-11-30,Total,5878,5654,44,11576
2021-12-01,Māori,2925,1123,12,4060
2021-12-01,Pacific peoples,1412,1268,4,2684
2021-12-01,Asian,333,1004,2,1339
2021-12-01,"Middle Eastern, Latin American and African (MELAA)",86,185,2,273
2021-12-01,European or Other,1140,2052,24,3216
2021-12-01,Unknown,112,39,0,151
2021-12-01,Total,6008,5671,44,11723
2021-12-02,Māori,2988,1145,12,4145
2021-12-02,Pacific peoples,1464,1269,4,2737
2021-12-02,Asian,342,1006,2,1350
2021-12-02,"Middle Eastern, Latin American and African (MELAA)",90,185,2,277
2021-12-02,European or Other,1149,2060,24,3233
2021-12-02,Unknown,114,39,0,153
2021-12-02,Total,6147,5704,44,11895
2021-12-03,Māori,2987,1182,12,4181
2021-12-03,Pacific peoples,1498,1272,4,2774
2021-12-03,Asian,341,1011,2,1354
2021-12-03,"Middle Eastern, Latin American and African (MELAA)",91,186,2,279
2021-12-03,European or Other,1155,2068,24,3247
2021-12-03,Unknown,117,40,0,157
2021-12-03,Total,6189,5759,44,11992
2021-12-04,Māori,3044,1192,12,4248
2021-12-04,Pacific peoples,1509,1275,4,2788
2021-12-04,Asian,347,1011,2,1360
2021-12-04,"Middle Eastern, Latin American and African (MELAA)",93,186,2,281
2021-12-04,European or Other,1158,2069,24,3251
2021-12-04,Unknown,119,40,0,159
2021-12-04,Total,6270,5773,44,12087
2021-12-05,Māori,3054,1235,12,4301
2021-12-05,Pacific peoples,1528,1282,4,2814
2021-12-05,Asian,349,1013,2,1364
2021-12-05,"Middle Eastern, Latin American and African (MELAA)",103,186,2,291
2021-12-05,European or Other,1164,2078,24,3266
2021-12-05,Unknown,119,40,0,159
2021-12-05,Total,6317,5834,44,12195
2021-12-06,Māori,3085,1272,12,4369
2021-12-06,Pacific peoples,1570,1286,4,2860
2021-12-06,Asian,354,1015,2,1371
2021-12-06,"Middle Eastern, Latin American and African (MELAA)",104,187,2,293
2021-12-06,European or Other,1170,2085,24,3279
2021-12-06,Unknown,119,40,0,159
2021-12-06,Total,6402,5885,44,12331
2021-12-07,Māori,3086,1316,12,4414
2021-12-07,Pacific peoples,1588,1296,4,2888
2021-12-07,Asian,350,1025,2,1377
2021-12-07,"Middle Eastern, Latin American and African (MELAA)",107,189,2,298
2021-12-07,European or Other,1168,2103,24,3295
2021-12-07,Unknown,117,39,0,156
2021-12-07,Total,6416,5968,44,12428
2021-12-08,Māori,3102,1347,12,4461
2021-12-08,Pacific peoples,1610,1302,4,2916
2021-12-08,Asian,353,1025,2,1380
2021-12-08,"Middle Eastern, Latin American and African (MELAA)",107,189,2,298
2021-12-08,European or Other,1169,2107,24,3300
2021-12-08,Unknown,122,39,0,161
2021-12-08,Total,6463,6009,44,12516
2021-12-09,Māori,3137,1353,12,4502
2021-12-09,Pacific peoples,1638,1303,4,2945
2021-12-09,Asian,366,1025,2,1393
2021-12-09,"Middle Eastern, Latin American and African (MELAA)",109,189,2,300
2021-12-09,European or Other,1182,2110,24,3316
2021-12-09,Unknown,126,39,0,165
2021-12-09,Total,6558,6019,44,12621
2021-12-10,Māori,3166,1365,12,4543
2021-12-10,Pacific peoples,1664,1307,4,2975
2021-12-10,Asian,370,1027,2,1399
2021-12-10,"Middle Eastern, Latin American and African (MELAA)",109,189,2,300
2021-12-10,European or Other,1190,2115,24,3329
2021-12-10,Unknown,131,40,0,171
2021-12-10,Total,6630,6043,44,12717
2021-12-11,Māori,3163,1388,14,4565
2021-12-11,Pacific peoples,1682,1310,4,2996
2021-12-11,Asian,378,1028,2,1408
2021-12-11,"Middle Eastern, Latin American and African (MELAA)",110,189,2,301
2021-12-11,European or Other,1194,2118,24,3336
2021-12-11,Unknown,134,41,0,175
2021-12-11,Total,6661,6074,46,12781
2021-12-12,Māori,3225,1402,14,4641
2021-12-12,Pacific peoples,1720,1318,4,3042
2021-12-12,Asian,389,1033,2,1424
2021-12-12,"Middle Eastern, Latin American and African (MELAA)",117,189,2,308
2021-12-12,European or Other,1222,2126,24,3372
2021-12-12,Unknown,65,32,0,97
2021-12-12,Total,6738,6100,46,12884
2021-12-13,Māori,3247,1417,14,4678
2021-12-13,Pacific peoples,1771,1327,4,3102
2021-12-13,Asian,393,1033,3,1429
2021-12-13,"Middle Eastern, Latin American and African (MELAA)",118,189,2,309
2021-12-13,European or Other,1221,2130,24,3375
2021-12-13,Unknown,61,32,0,93
2021-12-13,Total,6811,6128,47,12986
2021-12-14,Māori,3283,1439,14,4736
2021-12-14,Pacific peoples,1803,1327,4,3134
2021-12-14,Asian,401,1035,3,1439
2021-12-14,"Middle Eastern, Latin American and African (MELAA)",118,190,2,310
2021-12-14,European or Other,1222,2136,24,3382
2021-12-14,Unknown,36,30,0,66
2021-12-14,Total,6863,6157,47,13067
2021-12-15,Māori,3298,1465,14,4777
2021-12-15,Pacific peoples,1819,1328,4,3151
2021-12-15,Asian,405,1037,3,1445
2021-12-15,"Middle Eastern, Latin American and African (MELAA)",118,190,2,310
2021-12-15,European or Other,1233,2142,24,3399
2021-12-15,Unknown,30,31,0,61
2021-12-15,Total,6903,6193,47,13143
2021-12-16,Māori,1048,3747,15,4810
2021-12-16,Pacific peoples,691,2477,4,3172
2021-12-16,Asian,136,1312,3,1451
2021-12-16,"Middle Eastern, Latin American and African (MELAA)",47,264,2,313
2021-12-16,European or Other,267,3126,24,3417
2021-12-16,Unknown,30,45,0,75
2021-12-16,Total,2219,10971,48,13238
2021-12-17,Māori,971,3859,16,4846
2021-12-17,Pacific peoples,659,2530,4,3193
2021-12-17,Asian,139,1317,3,1459
2021-12-17,"Middle Eastern, Latin American and African (MELAA)",47,266,2,315
2021-12-17,European or Other,257,3150,24,3431
2021-12-17,Unknown,29,44,0,73
2021-12-17,Total,2102,11166,49,13317
2021-12-18,Māori,902,3945,16,4863
2021-12-18,Pacific peoples,638,2564,4,3206
2021-12-18,Asian,130,1332,3,1465
2021-12-18,"Middle Eastern, Latin American and African (MELAA)",48,267,2,317
2021-12-18,European or Other,246,3172,24,3442
2021-12-18,Unknown,29,44,0,73
2021-12-18,Total,1993,11324,49,13366
2021-12-18,Māori,836,4034,16,4886
2021-12-18,Pacific peoples,615,2602,4,3221
2021-12-18,Asian,135,1336,3,1474
2021-12-18,"Middle Eastern, Latin American and African (MELAA)",45,270,2,317
2021-12-18,European or Other,240,3188,24,3452
2021-12-18,Unknown,31,44,0,75
2021-12-18,Total,1902,11474,49,13425
2021-12-19,Māori,836,4034,16,4886
2021-12-19,Pacific peoples,615,2602,4,3221
2021-12-19,Asian,135,1336,3,1474
2021-12-19,"Middle Eastern, Latin American and African (MELAA)",45,270,2,317
2021-12-19,European or Other,240,3188,24,3452
2021-12-19,Unknown,31,44,0,75
2021-12-19,Total,1902,11474,49,13425
2021-12-19,Māori,784,4114,16,4914
2021-12-19,Pacific peoples,586,2655,4,3245
2021-12-19,Asian,128,1350,3,1481
2021-12-19,"Middle Eastern, Latin American and African (MELAA)",46,273,2,321
2021-12-19,European or Other,228,3210,24,3462
2021-12-19,Unknown,32,40,0,72
2021-12-19,Total,1804,11642,49,13495
2021-12-20,Māori,738,4186,16,4940
2021-12-20,Pacific peoples,563,2686,4,3253
2021-12-20,Asian,126,1355,3,1484
2021-12-20,"Middle Eastern, Latin American and African (MELAA)",47,274,2,323
2021-12-20,European or Other,220,3231,24,3475
2021-12-20,Unknown,27,29,0,56
2021-12-20,Total,1721,11761,49,13531
2021-12-21,Māori,704,4248,16,4968
2021-12-21,Pacific peoples,534,2730,4,3268
2021-12-21,Asian,125,1364,3,1492
2021-12-21,"Middle Eastern, Latin American and African (MELAA)",54,276,2,332
2021-12-21,European or Other,217,3251,24,3492
2021-12-21,Unknown,19,18,0,37
2021-12-21,Total,1653,11887,49,13589
2021-12-22,Māori,671,4306,16,4993
2021-12-22,Pacific peoples,512,2774,4,3290
2021-12-22,Asian,124,1372,3,1499
2021-12-22,"Middle Eastern, Latin American and African (MELAA)",54,278,2,334
2021-12-22,European or Other,210,3266,24,3500
2021-12-22,Unknown,14,18,0,32
2021-12-22,Total,1585,12014,49,13648
2021-12-23,Māori,649,4352,16,5017
2021-12-23,Pacific peoples,490,2811,4,3305
2021-12-23,Asian,124,1377,3,1504
2021-12-23,"Middle Eastern, Latin American and African (MELAA)",55,280,2,337
2021-12-23,European or Other,211,3284,24,3519
2021-12-23,Unknown,19,18,0,37
2021-12-23,Total,1548,12122,49,13719
2021-12-25,Māori,552,4487,17,5056
2021-12-25,Pacific peoples,486,2865,4,3355
2021-12-25,Asian,129,1389,3,1521
2021-12-25,"Middle Eastern, Latin American and African (MELAA)",49,292,2,343
2021-12-25,European or Other,208,3310,24,3542
2021-12-25,Unknown,20,18,0,38
2021-12-25,Total,1444,12361,50,13855
2021-12-26,Māori,518,4532,17,5067
2021-12-26,Pacific peoples,467,2895,4,3366
2021-12-26,Asian,129,1395,3,1527
2021-12-26,"Middle Eastern, Latin American and African (MELAA)",49,294,2,345
2021-12-26,European or Other,206,3323,24,3553
2021-12-26,Unknown,22,19,0,41
2021-12-26,Total,1391,12458,50,13899
2021-12-27,Māori,488,4567,17,5072
2021-12-27,Pacific peoples,446,2921,4,3371
2021-12-27,Asian,132,1399,3,1534
2021-12-27,"Middle Eastern, Latin American and African (MELAA)",51,297,2,350
2021-12-27,European or Other,194,3343,24,3561
2021-12-27,Unknown,23,21,0,44
2021-12-27,Total,1334,12548,50,13932
2021-12-28,Māori,441,4627,18,5086
2021-12-28,Pacific peoples,430,2954,4,3388
2021-12-28,Asian,138,1403,3,1544
2021-12-28,"Middle Eastern, Latin American and African (MELAA)",50,301,2,353
2021-12-28,European or Other,186,3357,24,3567
2021-12-28,Unknown,27,21,0,48
2021-12-28,Total,1272,12663,51,13986
2021-12-29,Māori,408,4674,18,5100
2021-12-29,Pacific peoples,413,2987,4,3404
2021-12-29,Asian,125,1419,3,1547
2021-12-29,"Middle Eastern, Latin American and African (MELAA)",52,304,2,358
2021-12-29,European or Other,194,3375,24,3593
2021-12-29,Unknown,34,21,0,55
2021-12-29,Total,1226,12780,51,14057
2021-12-30,Māori,392,4715,18,5125
2021-12-30,Pacific peoples,396,3015,4,3415
2021-12-30,Asian,121,1428,3,1552
2021-12-30,"Middle Eastern, Latin American and African (MELAA)",51,305,2,358
2021-12-30,European or Other,200,3386,24,3610
2021-12-30,Unknown,37,21,0,58
2021-12-30,Total,1197,12870,51,14118
2022-01-01,Māori,367,4776,18,5161
2022-01-01,Pacific peoples,362,3083,4,3449
2022-01-01,Asian,124,1440,3,1567
2022-01-01,"Middle Eastern, Latin American and African (MELAA)",48,313,2,363
2022-01-01,European or Other,214,3410,24,3648
2022-01-01,Unknown,45,22,0,67
2022-01-01,Total,1160,13044,51,14255
2022-01-02,Māori,356,4797,18,5171
2022-01-02,Pacific peoples,333,3117,4,3454
2022-01-02,Asian,122,1443,3,1568
2022-01-02,"Middle Eastern, Latin American and African (MELAA)",44,318,2,364
2022-01-02,European/other,229,3419,24,3672
2022-01-02,Unknown,54,23,0,77
2022-01-02,Total,1138,13117,51,14306
2022-01-03,Māori,348,4816,18,5182
2022-01-03,Pacific peoples,322,3138,4,3464
2022-01-03,Asian,121,1449,3,1573
2022-01-03,"Middle Eastern, Latin American and African (MELAA)",45,318,2,365
2022-01-03,European/other,244,3427,24,3695
2022-01-03,Unknown,63,23,0,86
2022-01-03,Total,1143,13171,51,14365
2022-01-04,Māori,330,4844,18,5192
2022-01-04,Pacific peoples,307,3158,4,3469
2022-01-04,Asian,117,1457,3,1577
2022-01-04,"Middle Eastern, Latin American and African (MELAA)",47,319,2,368
2022-01-04,European/other,236,3449,24,3709
2022-01-04,Unknown,65,25,0,90
2022-01-04,Total,1102,13252,51,14405
2022-01-05,Māori,307,4875,18,5200
2022-01-05,Pacific peoples,288,3182,4,3474
2022-01-05,Asian,123,1465,3,1591
2022-01-05,"Middle Eastern, Latin American and African (MELAA)",45,322,2,369
2022-01-05,European/other,243,3468,24,3735
2022-01-05,Unknown,75,23,0,98
2022-01-05,Total,1081,13335,51,14467
2022-01-06,Māori,296,4904,18,5218
2022-01-06,Pacific peoples,275,3203,4,3482
2022-01-06,Asian,131,1473,3,1607
2022-01-06,"Middle Eastern, Latin American and African (MELAA)",51,324,2,377
2022-01-06,European/other,256,3482,24,3762
2022-01-06,Unknown,59,20,0,79
2022-01-06,Total,1068,13406,51,14525
2022-01-08,Māori,288,4941,18,5247
2022-01-08,Pacific peoples,264,3242,4,3510
2022-01-08,Asian,136,1493,3,1632
2022-01-08,"Middle Eastern, Latin American and African (MELAA)",59,325,2,386
2022-01-08,European/other,289,3517,24,3830
2022-01-08,Unknown,51,17,0,68
2022-01-08,Total,1087,13535,51,14673
2022-01-09,Māori,269,4968,18,5255
2022-01-09,Pacific peoples,255,3259,4,3518
2022-01-09,Asian,143,1498,3,1644
2022-01-09,"Middle Eastern, Latin American and African (MELAA)",58,327,2,387
2022-01-09,European/other,293,3538,24,3855
2022-01-09,Unknown,55,19,0,74
2022-01-09,Total,1073,13609,51,14733
2022-01-10,Māori,251,4989,18,5258
2022-01-10,Pacific peoples,246,3268,4,3518
2022-01-10,Asian,149,1501,3,1653
2022-01-10,"Middle Eastern, Latin American and African (MELAA)",60,327,2,389
2022-01-10,European/other,294,3550,24,3868
2022-01-10,Unknown,51,19,0,70
2022-01-10,Total,1051,13654,51,14756
2022-01-11,Māori,229,5023,18,5270
2022-01-11,Pacific peoples,233,3289,4,3526
2022-01-11,Asian,170,1507,4,1681
2022-01-11,"Middle Eastern, Latin American and African (MELAA)",60,332,2,394
2022-01-11,European/other,311,3564,24,3899
2022-01-11,Unknown,59,19,0,78
2022-01-11,Total,1062,13734,52,14848
2022-01-12,Māori,214,5050,18,5282
2022-01-12,Pacific peoples,212,3311,4,3527
2022-01-12,Asian,165,1513,4,1682
2022-01-12,"Middle Eastern, Latin American and African (MELAA)",56,337,2,395
2022-01-12,European/other,325,3569,24,3918
2022-01-12,Unknown,63,20,0,83
2022-01-12,Total,1035,13800,52,14887
2022-01-13,Māori,209,5068,18,5295
2022-01-13,Pacific peoples,207,3321,4,3532
2022-01-13,Asian,171,1518,4,1693
2022-01-13,"Middle Eastern, Latin American and African (MELAA)",58,338,2,398
2022-01-13,European/other,335,3579,24,3938
2022-01-13,Unknown,71,20,0,91
2022-01-13,Total,1051,13844,52,14947
2022-01-14,Māori,209,5086,18,5313
2022-01-14,Pacific peoples,181,3355,4,3540
2022-01-14,Asian,167,1532,4,1703
2022-01-14,"Middle Eastern, Latin American and African (MELAA)",51,345,2,398
2022-01-14,European/other,324,3606,24,3954
2022-01-14,Unknown,73,20,0,93
2022-01-14,Total,1005,13944,52,15001
2022-01-15,Māori,201,5101,18,5320
2022-01-15,Pacific peoples,165,3374,4,3543
2022-01-15,Asian,184,1537,4,1725
2022-01-15,"Middle Eastern, Latin American and African (MELAA)",56,346,2,404
2022-01-15,European/other,338,3614,24,3976
2022-01-15,Unknown,81,20,0,101
2022-01-15,Total,1025,13992,52,15069
2022-01-16,Māori,200,5114,18,5332
2022-01-16,Pacific peoples,156,3383,4,3543
2022-01-16,Asian,189,1555,4,1748
2022-01-16,"Middle Eastern, Latin American and African (MELAA)",54,349,2,405
2022-01-16,European/other,336,3630,24,3990
2022-01-16,Unknown,89,20,0,109
2022-01-16,Total,1024,14051,52,15127
2022-01-17,Māori,196,5122,18,5336
2022-01-17,Pacific peoples,154,3390,4,3548
2022-01-17,Asian,194,1560,4,1758
2022-01-17,"Middle Eastern, Latin American and African (MELAA)",53,352,2,407
2022-01-17,European/other,335,3645,24,4004
2022-01-17,Unknown,96,21,0,117
2022-01-17,Total,1028,14090,52,15170
2022-01-18,Māori,198,5137,18,5353
2022-01-18,Pacific peoples,140,3412,4,3556
2022-01-18,Asian,206,1575,4,1785
2022-01-18,"Middle Eastern, Latin American and African (MELAA)",47,361,2,410
2022-01-18,European/other,331,3665,24,4020
2022-01-18,Unknown,104,21,0,125
2022-01-18,Total,1026,14171,52,15249
2022-01-19,Māori,208,5145,18,5371
2022-01-19,Pacific peoples,132,3424,4,3560
2022-01-19,Asian,204,1591,4,1799
2022-01-19,"Middle Eastern, Latin American and African (MELAA)",44,365,2,411
2022-01-19,European/other,330,3696,24,4050
2022-01-19,Unknown,119,24,0,143
2022-01-19,Total,1037,14245,52,15334
2022-01-20,Māori,194,5171,18,5383
2022-01-20,Pacific peoples,133,3434,4,3571
2022-01-20,Asian,216,1597,4,1817
2022-01-20,"Middle Eastern, Latin American and African (MELAA)",46,367,2,415
2022-01-20,European/other,335,3706,24,4065
2022-01-20,Unknown,125,25,0,150
2022-01-20,Total,1049,14300,52,15401
2022-01-21,Māori,189,5194,18,5401
2022-01-21,Pacific peoples,128,3446,4,3578
2022-01-21,Asian,249,1601,4,1854
2022-01-21,"Middle Eastern, Latin American and African (MELAA)",47,368,2,417
2022-01-21,European/other,319,3725,24,4068
2022-01-21,Unknown,136,25,0,161
2022-01-21,Total,1068,14359,52,15479
2022-01-22,Māori,183,5208,18,5409
2022-01-22,Pacific peoples,120,3459,4,3583
2022-01-22,Asian,277,1603,4,1884
2022-01-22,"Middle Eastern, Latin American and African (MELAA)",46,371,2,419
2022-01-22,European/other,324,3736,24,4084
2022-01-22,Unknown,146,25,0,171
2022-01-22,Total,1096,14402,52,15550
2022-01-23,Māori,181,5217,18,5416
2022-01-23,Pacific peoples,118,3464,4,3586
2022-01-23,Asian,297,1606,4,1907
2022-01-23,"Middle Eastern, Latin American and African (MELAA)",48,372,2,422
2022-01-23,European/other,329,3756,24,4109
2022-01-23,Unknown,160,25,0,185
2022-01-23,Total,1133,14440,52,15625
2022-01-24,Māori,185,5224,18,5427
2022-01-24,Pacific peoples,118,3470,4,3592
2022-01-24,Asian,321,1606,4,1931
2022-01-24,"Middle Eastern, Latin American and African (MELAA)",48,373,2,423
2022-01-24,European/other,326,3772,24,4122
2022-01-24,Unknown,166,26,0,192
2022-01-24,Total,1164,14471,52,15687
2022-01-25,Māori,182,5235,18,5435
2022-01-25,Pacific peoples,119,3475,4,3598
2022-01-25,Asian,337,1610,4,1951
2022-01-25,"Middle Eastern, Latin American and African (MELAA)",44,378,2,424
2022-01-25,European/other,337,3776,24,4137
2022-01-25,Unknown,171,29,0,200
2022-01-25,Total,1190,14503,52,15745
2022-01-26,Māori,191,5247,18,5456
2022-01-26,Pacific peoples,119,3479,4,3602
2022-01-26,Asian,363,1620,4,1987
2022-01-26,"Middle Eastern, Latin American and African (MELAA)",49,378,2,429
2022-01-26,European/other,349,3788,24,4161
2022-01-26,Unknown,170,37,0,207
2022-01-26,Total,1241,14549,52,15842
2022-01-27,Māori,176,5271,18,5465
2022-01-27,Pacific peoples,125,3488,4,3617
2022-01-27,Asian,421,1629,4,2054
2022-01-27,"Middle Eastern, Latin American and African (MELAA)",52,380,2,434
2022-01-27,European/other,366,3808,24,4198
2022-01-27,Unknown,180,43,0,223
2022-01-27,Total,1320,14619,52,15991
2022-01-28,Māori,176,5281,18,5475
2022-01-28,Pacific peoples,118,3502,4,3624
2022-01-28,Asian,490,1641,4,2135
2022-01-28,"Middle Eastern, Latin American and African (MELAA)",50,389,2,441
2022-01-28,European/other,378,3831,24,4233
2022-01-28,Unknown,193,45,0,238
2022-01-28,Total,1405,14689,52,16146
2022-01-29,Māori,193,5283,18,5494
2022-01-29,Pacific peoples,121,3510,4,3635
2022-01-29,Asian,538,1653,4,2195
2022-01-29,"Middle Eastern, Latin American and African (MELAA)",51,390,2,443
2022-01-29,European/other,394,3847,24,4265
2022-01-29,Unknown,200,54,0,254
2022-01-29,Total,1497,14737,52,16286
2022-01-30,Māori,187,5296,18,5501
2022-01-30,Pacific peoples,121,3519,5,3645
2022-01-30,Asian,594,1667,4,2265
2022-01-30,"Middle Eastern, Latin American and African (MELAA)",50,392,2,444
2022-01-30,European/other,396,3873,24,4293
2022-01-30,Unknown,205,63,0,268
2022-01-30,Total,1553,14810,53,16416
2022-01-31,Māori,186,5302,18,5506
2022-01-31,Pacific peoples,144,3522,5,3671
2022-01-31,Asian,684,1687,4,2375
2022-01-31,"Middle Eastern, Latin American and African (MELAA)",62,393,2,457
2022-01-31,European/other,414,3896,24,4334
2022-01-31,Unknown,212,65,0,277
2022-01-31,Total,1702,14865,53,16620
2022-02-01,Māori,187,5316,18,5521
2022-02-01,Pacific peoples,173,3526,5,3704
2022-02-01,Asian,754,1697,4,2455
2022-02-01,"Middle Eastern, Latin American and African (MELAA)",69,395,2,466
2022-02-01,European/other,435,3922,24,4381
2022-02-01,Unknown,217,73,0,290
2022-02-01,Total,1835,14929,53,16817
2022-02-02,Māori,201,5322,18,5541
2022-02-02,Pacific peoples,210,3530,5,3745
2022-02-02,Asian,816,1709,4,2529
2022-02-02,"Middle Eastern, Latin American and African (MELAA)",72,397,2,471
2022-02-02,European/other,458,3943,24,4425
2022-02-02,Unknown,217,77,0,294
2022-02-02,Total,1974,14978,53,17005
2022-02-03,Māori,211,5342,18,5571
2022-02-03,Pacific peoples,253,3535,5,3793
2022-02-03,Asian,905,1722,4,2631
2022-02-03,"Middle Eastern, Latin American and African (MELAA)",75,403,2,480
2022-02-03,European/other,510,3966,24,4500
2022-02-03,Unknown,225,77,0,302
2022-02-03,Total,2179,15045,53,17277
2022-02-04,Māori,228,5350,18,5596
2022-02-04,Pacific peoples,312,3544,5,3861
2022-02-04,Asian,986,1739,4,2729
2022-02-04,"Middle Eastern, Latin American and African (MELAA)",83,403,2,488
2022-02-04,European/other,545,3987,24,4556
2022-02-04,Unknown,234,82,0,316
2022-02-04,Total,2388,15105,53,17546
2022-02-05,Māori,230,5367,18,5615
2022-02-05,Pacific peoples,357,3546,5,3908
2022-02-05,Asian,1059,1781,4,2844
2022-02-05,"Middle Eastern, Latin American and African (MELAA)",79,409,2,490
2022-02-05,European/other,564,4002,24,4590
2022-02-05,Unknown,230,96,0,326
2022-02-05,Total,2519,15201,53,17773
2022-02-06,Māori,247,5369,18,5634
2022-02-06,Pacific peoples,409,3546,5,3960
2022-02-06,Asian,1132,1796,4,2932
2022-02-06,"Middle Eastern, Latin American and African (MELAA)",85,411,2,498
2022-02-06,European/other,590,4009,24,4623
2022-02-06,Unknown,244,97,0,341
2022-02-06,Total,2707,15228,53,17988
2022-02-07,Māori,264,5378,18,5660
2022-02-07,Pacific peoples,471,3549,5,4025
2022-02-07,Asian,1187,1836,4,3027
2022-02-07,"Middle Eastern, Latin American and African (MELAA)",91,414,2,507
2022-02-07,European/other,611,4038,24,4673
2022-02-07,Unknown,256,105,0,361
2022-02-07,Total,2880,15320,53,18253
2022-02-08,Māori,278,5389,18,5685
2022-02-08,Pacific peoples,508,3554,5,4067
2022-02-08,Asian,1267,1875,4,3146
2022-02-08,"Middle Eastern, Latin American and African (MELAA)",97,419,2,518
2022-02-08,European/other,623,4063,24,4710
2022-02-08,Unknown,262,115,0,377
2022-02-08,Total,3035,15415,53,18503
2022-02-09,Māori,321,5407,18,5746
2022-02-09,Pacific peoples,596,3561,5,4162
2022-02-09,Asian,1356,1905,4,3265
2022-02-09,"Middle Eastern, Latin American and African (MELAA)",107,420,2,529
2022-02-09,European/other,653,4078,24,4755
2022-02-09,Unknown,252,128,0,380
2022-02-09,Total,3285,15499,53,18837
2022-02-10,Māori,361,5413,18,5792
2022-02-10,Pacific peoples,764,3576,5,4345
2022-02-10,Asian,1444,1956,4,3404
2022-02-10,"Middle Eastern, Latin American and African (MELAA)",110,425,2,537
2022-02-10,European/other,701,4092,24,4817
2022-02-10,Unknown,280,138,0,418
2022-02-10,Total,3660,15600,53,19313
2022-02-11,Māori,395,5422,18,5835
2022-02-11,Pacific peoples,935,3582,5,4522
2022-02-11,Asian,1553,1979,4,3536
2022-02-11,"Middle Eastern, Latin American and African (MELAA)",115,427,2,544
2022-02-11,European/other,761,4108,24,4893
2022-02-11,Unknown,300,147,0,447
2022-02-11,Total,4059,15665,53,19777
2022-02-13,Māori,579,5436,18,6033
2022-02-13,Pacific peoples,1838,3595,5,5438
2022-02-13,Asian,1870,2091,4,3965
2022-02-13,"Middle Eastern, Latin American and African (MELAA)",163,442,2,607
2022-02-13,European/other,1072,4190,24,5286
2022-02-13,Unknown,134,110,0,244
2022-02-13,Total,5656,15864,53,21573
2022-02-14,Māori,689,5447,18,6154
2022-02-14,Pacific peoples,2164,3604,5,5773
2022-02-14,Asian,1952,2143,4,4099
2022-02-14,"Middle Eastern, Latin American and African (MELAA)",175,445,2,622
2022-02-14,European/other,1192,4214,24,5430
2022-02-14,Unknown,137,113,0,250
2022-02-14,Total,6309,15966,53,22328
2022-02-15,Māori,799,5460,18,6277
2022-02-15,Pacific peoples,2724,3614,5,6343
2022-02-15,Asian,2098,2192,4,4294
2022-02-15,"Middle Eastern, Latin American and African (MELAA)",201,449,2,652
2022-02-15,European/other,1391,4261,24,5676
2022-02-15,Unknown,152,115,0,267
2022-02-15,Total,7365,16091,53,23509
2022-02-16,Māori,976,5484,18,6478
2022-02-16,Pacific peoples,3422,3623,5,7050
2022-02-16,Asian,2284,2259,4,4547
2022-02-16,"Middle Eastern, Latin American and African (MELAA)",232,456,2,690
2022-02-16,European/other,1663,4322,24,6009
2022-02-16,Unknown,157,119,0,276
2022-02-16,Total,8734,16263,53,25050
2022-02-17,Māori,1196,5511,18,6725
2022-02-17,Pacific peoples,4245,3647,5,7897
2022-02-17,Asian,2500,2318,4,4822
2022-02-17,"Middle Eastern, Latin American and African (MELAA)",263,458,2,723
2022-02-17,European/other,2034,4408,24,6466
2022-02-17,Unknown,174,128,0,302
2022-02-17,Total,10412,16470,53,26935
2022-02-18,Māori,1422,5520,18,6960
2022-02-18,Pacific peoples,5019,3652,5,8676
2022-02-18,Asian,2690,2394,4,5088
2022-02-18,"Middle Eastern, Latin American and African (MELAA)",297,465,2,764
2022-02-18,European/other,2489,4438,24,6951
2022-02-18,Unknown,175,137,0,312
2022-02-18,Total,12092,16606,53,28751
2022-02-19,Māori,1718,5540,18,7276
2022-02-19,Pacific peoples,6050,3665,5,9720
2022-02-19,Asian,2934,2481,4,5419
2022-02-19,"Middle Eastern, Latin American and African (MELAA)",356,467,2,825
2022-02-19,European/other,3024,4476,24,7524
2022-02-19,Unknown,177,146,0,323
2022-02-19,Total,14259,16775,53,31087
2022-02-20,Māori,1993,5552,18,7563
2022-02-20,Pacific peoples,7012,3681,5,10698
2022-02-20,Asian,3177,2534,4,5715
2022-02-20,"Middle Eastern, Latin American and African (MELAA)",405,472,2,879
2022-02-20,European/other,3603,4500,24,8127
2022-02-20,Unknown,181,154,0,335
2022-02-20,Total,16371,16893,53,33317
2022-02-21,Māori,2355,5565,19,7939
2022-02-21,Pacific peoples,8112,3705,7,11824
2022-02-21,Asian,3465,2624,4,6093
2022-02-21,"Middle Eastern, Latin American and African (MELAA)",462,485,2,949
2022-02-21,European/other,4441,4541,24,9006
2022-02-21,Unknown,191,160,0,351
2022-02-21,Total,19026,17080,56,36162
2022-02-22,Māori,2797,5591,19,8407
2022-02-22,Pacific peoples,9160,3737,7,12904
2022-02-22,Asian,3770,2693,4,6467
2022-02-22,"Middle Eastern, Latin American and African (MELAA)",533,489,2,1024
2022-02-22,European/other,5540,4593,24,10157
2022-02-22,Unknown,222,164,0,386
2022-02-22,Total,22022,17267,56,39345
2022-02-23,Māori,3671,5618,19,9308
2022-02-23,Pacific peoples,11055,3796,7,14858
2022-02-23,Asian,4421,2765,4,7190
2022-02-23,"Middle Eastern, Latin American and African (MELAA)",667,495,2,1164
2022-02-23,European/other,7888,4630,24,12542
2022-02-23,Unknown,247,164,0,411
2022-02-23,Total,27949,17468,56,45473
2022-02-24,Māori,5560,5654,19,11233
2022-02-24,Pacific peoples,14728,3844,7,18579
2022-02-24,Asian,5962,2859,4,8825
2022-02-24,"Middle Eastern, Latin American and African (MELAA)",967,497,2,1466
2022-02-24,European/other,12173,4691,24,16888
2022-02-24,Unknown,330,176,0,506
2022-02-24,Total,39720,17721,56,57497
2022-02-25,Māori,7684,5675,19,13378
2022-02-25,Pacific peoples,18962,3905,7,22874
2022-02-25,Asian,7902,2944,4,10850
2022-02-25,"Middle Eastern, Latin American and African (MELAA)",1321,506,2,1829
2022-02-25,European/other,16856,4739,24,21619
2022-02-25,Unknown,394,178,0,572
2022-02-25,Total,53119,17947,56,71122
2022-02-26,Māori,10082,5682,19,15783
2022-02-26,Pacific peoples,23444,3957,7,27408
2022-02-26,Asian,10022,3034,4,13060
2022-02-26,"Middle Eastern, Latin American and African (MELAA)",1709,507,2,2218
2022-02-26,European/other,22228,4756,24,27008
2022-02-26,Unknown,483,178,0,661
2022-02-26,Total,67968,18114,56,86138
2022-02-27,Māori,12578,5700,19,18297
2022-02-27,Pacific peoples,27641,4012,7,31660
2022-02-27,Asian,12278,3136,4,15418
2022-02-27,"Middle Eastern, Latin American and African (MELAA)",2035,516,2,2553
2022-02-27,European/other,27335,4790,24,32149
2022-02-27,Unknown,566,178,0,744
2022-02-27,Total,82433,18332,56,100821
2022-02-28,Māori,15843,5729,19,21591
2022-02-28,Pacific peoples,32434,4081,7,36522
2022-02-28,Asian,15090,3243,4,18337
2022-02-28,"Middle Eastern, Latin American and African (MELAA)",2498,525,2,3025
2022-02-28,European/other,33480,4842,24,38346
2022-02-28,Unknown,798,193,0,991
2022-02-28,Total,100143,18613,56,118812
2022-03-01,Māori,20324,5748,19,26091
2022-03-01,Pacific peoples,38818,4110,7,42935
2022-03-01,Asian,18706,3303,4,22013
2022-03-01,"Middle Eastern, Latin American and African (MELAA)",3108,535,2,3645
2022-03-01,European/other,42215,4857,24,47096
2022-03-01,Unknown,943,195,0,1138
2022-03-01,Total,124114,18748,56,142918
2022-03-02,Māori,24670,5822,19,30511
2022-03-02,Pacific peoples,44257,4283,7,48547
2022-03-02,Asian,22257,3462,4,25723
2022-03-02,"Middle Eastern, Latin American and African (MELAA)",3643,548,2,4193
2022-03-02,European/other,50856,4950,24,55830
2022-03-02,Unknown,1096,198,0,1294
2022-03-02,Total,146779,19263,56,166098
2022-03-03,Māori,26742,7919,21,34682
2022-03-03,Pacific peoples,42520,11802,9,54331
2022-03-03,Asian,23364,6117,4,29485
2022-03-03,"Middle Eastern, Latin American and African (MELAA)",3852,952,2,4806
2022-03-03,European/other,54879,9018,27,63924
2022-03-03,Unknown,1122,330,0,1452
2022-03-03,Total,152479,36138,63,188680
2022-03-04,Māori,30071,8423,21,38515
2022-03-04,Pacific peoples,45219,13007,9,58235
2022-03-04,Asian,26056,6521,4,32581
2022-03-04,"Middle Eastern, Latin American and African (MELAA)",4252,1031,2,5285
2022-03-04,European/other,61093,10228,27,71348
2022-03-04,Unknown,1228,370,0,1598
2022-03-04,Total,167919,39580,63,207562
2022-03-05,Māori,32627,8957,21,41605
2022-03-05,Pacific peoples,46607,14334,10,60951
2022-03-05,Asian,28133,6931,5,35069
2022-03-05,"Middle Eastern, Latin American and African (MELAA)",4516,1127,2,5645
2022-03-05,European/other,66319,11428,27,77774
2022-03-05,Unknown,1334,389,0,1723
2022-03-05,Total,179536,43166,65,222767
2022-03-06,Māori,35515,9628,21,45164
2022-03-06,Pacific peoples,48205,15619,10,63834
2022-03-06,Asian,30441,7425,5,37871
2022-03-06,"Middle Eastern, Latin American and African (MELAA)",4783,1243,2,6028
2022-03-06,European/other,72251,13305,27,85583
2022-03-06,Unknown,1413,426,0,1839
2022-03-06,Total,192608,47646,65,240319
2022-03-07,Māori,37022,13456,21,50499
2022-03-07,Pacific peoples,44569,23055,10,67634
2022-03-07,Asian,30599,10894,5,41498
2022-03-07,"Middle Eastern, Latin American and African (MELAA)",4692,1853,2,6547
2022-03-07,European/other,74366,21707,27,96100
2022-03-07,Unknown,1331,646,0,1977
2022-03-07,Total,192579,71611,65,264255
2022-03-08,Māori,40076,15500,21,55597
2022-03-08,Pacific peoples,43918,26913,10,70841
2022-03-08,Asian,31950,12838,5,44793
2022-03-08,"Middle Eastern, Latin American and African (MELAA)",4876,2175,2,7053
2022-03-08,European/other,80055,26277,27,106359
2022-03-08,Unknown,1382,725,0,2107
2022-03-08,Total,202257,84428,65,286750
2022-03-10,Māori,43664,21601,25,65290
2022-03-10,Pacific peoples,39560,36556,13,76129
2022-03-10,Asian,32670,18367,6,51043
2022-03-10,"Middle Eastern, Latin American and African (MELAA)",4973,3027,3,8003
2022-03-10,European/other,87621,38360,39,126020
2022-03-10,Unknown,1379,972,0,2351
2022-03-10,Total,209867,118883,86,328836
2022-03-11,Māori,43626,25832,25,69483
2022-03-11,Pacific peoples,36017,42321,13,78351
2022-03-11,Asian,31932,21797,7,53736
2022-03-11,"Middle Eastern, Latin American and African (MELAA)",4838,3601,3,8442
2022-03-11,European/other,88634,46424,45,135103
2022-03-11,Unknown,1358,1103,0,2461
2022-03-11,Total,206405,141078,93,347576
2022-03-12,Māori,42048,30329,28,72405
2022-03-12,Pacific peoples,31713,48075,13,79801
2022-03-12,Asian,30404,25557,7,55968
2022-03-12,"Middle Eastern, Latin American and African (MELAA)",4601,4162,3,8766
2022-03-12,European/other,87325,55241,50,142616
2022-03-12,Unknown,1296,1257,0,2553
2022-03-12,Total,197387,164621,101,362109
2022-03-13,Māori,41187,34490,28,75705
2022-03-13,Pacific peoples,27369,53830,14,81213
2022-03-13,Asian,28857,29305,7,58169
2022-03-13,"Middle Eastern, Latin American and African (MELAA)",4308,4763,3,9074
2022-03-13,European/other,87521,63315,50,150886
2022-03-13,Unknown,1225,1413,0,2638
2022-03-13,Total,190467,187116,102,377685
2022-03-14,Māori,42449,38313,28,80790
2022-03-14,Pacific peoples,25735,57727,14,83476
2022-03-14,Asian,28779,32387,7,61173
2022-03-14,"Middle Eastern, Latin American and African (MELAA)",4257,5242,3,9502
2022-03-14,European/other,90832,70742,50,161624
2022-03-14,Unknown,1213,1564,0,2777
2022-03-14,Total,193265,205975,102,399342
2022-03-16,Māori,44877,44925,32,89834
2022-03-16,Pacific peoples,23763,63227,21,87011
2022-03-16,Asian,28618,37664,8,66290
2022-03-16,"Middle Eastern, Latin American and African (MELAA)",4255,5979,3,10237
2022-03-16,European/other,97083,84915,71,182069
2022-03-16,Unknown,1251,1785,0,3036
2022-03-16,Total,199847,238495,135,438477
2022-03-17,Māori,27848,65249,32,93129
2022-03-17,Pacific peoples,12116,76082,22,88220
2022-03-17,Asian,17100,51071,8,68179
2022-03-17,"Middle Eastern, Latin American and African (MELAA)",2517,8006,3,10526
2022-03-17,European/other,63501,125930,73,189504
2022-03-17,Unknown,785,2327,0,3112
2022-03-17,Total,123867,328665,138,452670
2022-03-18,Māori,27924,69446,33,97403
2022-03-18,Pacific peoples,11408,78304,23,89735
2022-03-18,Asian,16849,53756,8,70613
2022-03-18,"Middle Eastern, Latin American and African (MELAA)",2445,8448,3,10896
2022-03-18,European/other,64223,135027,77,199327
2022-03-18,Unknown,816,2435,0,3251
2022-03-18,Total,123665,347416,144,471225
2022-03-19,Māori,27458,72366,35,99859
2022-03-19,Pacific peoples,10809,79758,25,90592
2022-03-19,Asian,16201,55975,8,72184
2022-03-19,"Middle Eastern, Latin American and African (MELAA)",2360,8769,4,11133
2022-03-19,European/other,63505,142545,79,206129
2022-03-19,Unknown,801,2524,0,3325
2022-03-19,Total,121134,361937,151,483222
2022-03-20,Māori,27073,75659,36,102768
2022-03-20,Pacific peoples,10308,81169,30,91507
2022-03-20,Asian,15935,58178,8,74121
2022-03-20,"Middle Eastern, Latin American and African (MELAA)",2304,9077,4,11385
2022-03-20,European/other,63635,150821,85,214541
2022-03-20,Unknown,804,2605,0,3409
2022-03-20,Total,120059,377509,163,497731
2022-03-21,Māori,26724,80048,37,106809
2022-03-21,Pacific peoples,9659,83230,35,92924
2022-03-21,Asian,15426,61143,11,76580
2022-03-21,"Middle Eastern, Latin American and African (MELAA)",2287,9494,4,11785
2022-03-21,European/other,64475,162510,90,227075
2022-03-21,Unknown,775,2737,0,3512
2022-03-21,Total,119346,399162,177,518685
2022-03-22,Māori,26566,84611,39,111216
2022-03-22,Pacific peoples,9292,84995,36,94323
2022-03-22,Asian,15067,63739,11,78817
2022-03-22,"Middle Eastern, Latin American and African (MELAA)",2278,9853,4,12135
2022-03-22,European/other,66043,172595,94,238732
2022-03-22,Unknown,743,2873,0,3616
2022-03-22,Total,119989,418666,184,538839
2022-03-23,Māori,26054,89088,40,115182
2022-03-23,Pacific peoples,8819,86752,37,95608
2022-03-23,Asian,14664,66256,12,80932
2022-03-23,"Middle Eastern, Latin American and African (MELAA)",2280,10218,4,12502
2022-03-23,European/other,66303,182953,99,249355
2022-03-23,Unknown,749,3002,0,3751
2022-03-23,Total,118869,438269,192,557330
2022-03-24,Māori,26160,92378,41,118579
2022-03-24,Pacific peoples,8618,87949,39,96606
2022-03-24,Asian,14654,68129,13,82796
2022-03-24,"Middle Eastern, Latin American and African (MELAA)",2311,10505,5,12821
2022-03-24,European/other,68122,190372,103,258597
2022-03-24,Unknown,760,3085,0,3845
2022-03-24,Total,120625,452418,201,573244
2022-03-25,Māori,25355,96120,42,121517
2022-03-25,Pacific peoples,8260,89273,42,97575
2022-03-25,Asian,14255,70205,14,84474
2022-03-25,"Middle Eastern, Latin American and African (MELAA)",2278,10804,5,13087
2022-03-25,European/other,67940,198816,114,266870
2022-03-25,Unknown,749,3195,0,3944
2022-03-25,Total,118837,468413,217,587467
2022-03-26,Māori,24263,99112,42,123417
2022-03-26,Pacific peoples,7815,90336,42,98193
2022-03-26,Asian,13550,72156,14,85720
2022-03-26,"Middle Eastern, Latin American and African (MELAA)",2143,11114,5,13262
2022-03-26,European/other,66026,207000,120,273146
2022-03-26,Unknown,714,3293,0,4007
2022-03-26,Total,114511,483011,223,597745
2022-03-27,Māori,23791,102013,45,125849
2022-03-27,Pacific peoples,7670,91246,42,98958
2022-03-27,Asian,13079,74090,15,87184
2022-03-27,"Middle Eastern, Latin American and African (MELAA)",2119,11366,5,13490
2022-03-27,European/other,65624,215397,124,281145
2022-03-27,Unknown,693,3368,0,4061
2022-03-27,Total,112976,497480,231,610687
2022-03-28,Māori,22780,106755,49,129584
2022-03-28,Pacific peoples,7051,92865,49,99965
2022-03-28,Asian,12458,76585,18,89061
2022-03-28,"Middle Eastern, Latin American and African (MELAA)",2016,11778,5,13799
2022-03-28,European/other,64221,226944,145,291310
2022-03-28,Unknown,701,3478,0,4179
2022-03-28,Total,109227,518405,266,627898
2022-03-29,Māori,21668,111162,51,132881
2022-03-29,Pacific peoples,6609,94269,50,100928
2022-03-29,Asian,11907,78811,19,90737
2022-03-29,"Middle Eastern, Latin American and African (MELAA)",1915,12132,5,14052
2022-03-29,European/other,62275,238577,153,301005
2022-03-29,Unknown,691,3581,0,4272
2022-03-29,Total,105065,538532,278,643875
2022-03-30,Māori,20631,115123,57,135811
2022-03-30,Pacific peoples,6296,95546,54,101896
2022-03-30,Asian,11460,80928,20,92408
2022-03-30,"Middle Eastern, Latin American and African (MELAA)",1790,12500,6,14296
2022-03-30,European/other,61032,249189,162,310383
2022-03-30,Unknown,666,3715,0,4381
2022-03-30,Total,101875,557001,299,659175
2022-03-31,Māori,19932,118522,58,138512
2022-03-31,Pacific peoples,6115,96546,56,102717
2022-03-31,Asian,11112,82789,20,93921
2022-03-31,"Middle Eastern, Latin American and African (MELAA)",1701,12821,6,14528
2022-03-31,European/other,59964,258428,174,318566
2022-03-31,Unknown,662,3806,0,4468
2022-03-31,Total,99486,572912,314,672712
2022-04-02,Māori,18858,123442,67,142367
2022-04-02,Pacific peoples,5542,98151,61,103754
2022-04-02,Asian,10503,85782,21,96306
2022-04-02,"Middle Eastern, Latin American and African (MELAA)",1613,13269,6,14888
2022-04-02,European/other,57910,273174,195,331279
2022-04-02,Unknown,652,3973,0,4625
2022-04-02,Total,95078,597791,350,693219
2022-04-03,Māori,18271,125792,69,144132
2022-04-03,Pacific peoples,5291,98887,62,104240
2022-04-03,Asian,10345,87174,21,97540
2022-04-03,"Middle Eastern, Latin American and African (MELAA)",1559,13486,6,15051
2022-04-03,European/other,56673,280938,205,337816
2022-04-03,Unknown,650,4038,0,4688
2022-04-03,Total,92789,610315,363,703467
2022-04-04,Māori,17424,129518,74,147016
2022-04-04,Pacific peoples,5076,99892,62,105030
2022-04-04,Asian,9996,89047,22,99065
2022-04-04,"Middle Eastern, Latin American and African (MELAA)",1466,13794,6,15266
2022-04-04,European/other,55159,291093,222,346474
2022-04-04,Unknown,639,4160,0,4799
2022-04-04,Total,89760,627504,386,717650
2022-04-05,Māori,16505,132813,74,149392
2022-04-05,Pacific peoples,4718,100853,63,105634
2022-04-05,Asian,9642,90731,22,100395
2022-04-05,"Middle Eastern, Latin American and African (MELAA)",1453,14048,6,15507
2022-04-05,European/other,53451,300785,239,354475
2022-04-05,Unknown,634,4248,0,4882
2022-04-05,Total,86403,643478,404,730285
2022-04-06,Māori,15773,135746,75,151594
2022-04-06,Pacific peoples,4345,101826,65,106236
2022-04-06,Asian,9312,92410,22,101744
2022-04-06,"Middle Eastern, Latin American and African (MELAA)",1410,14292,6,15708
2022-04-06,European/other,51368,310162,258,361788
2022-04-06,Unknown,591,4326,0,4917
2022-04-06,Total,82799,658762,426,741987
2022-04-08,Māori,14277,140720,80,155077
2022-04-08,Pacific peoples,3927,103249,69,107245
2022-04-08,Asian,8654,95279,23,103956
2022-04-08,"Middle Eastern, Latin American and African (MELAA)",1264,14738,6,16008
2022-04-08,European/other,47513,325444,267,373224
2022-04-08,Unknown,535,4495,0,5030
2022-04-08,Total,76170,683925,445,760540
2022-04-09,Māori,13810,142294,82,156186
2022-04-09,Pacific peoples,3799,103686,71,107556
2022-04-09,Asian,8403,96302,25,104730
2022-04-09,"Middle Eastern, Latin American and African (MELAA)",1203,14885,6,16094
2022-04-09,European/other,46353,331034,273,377660
2022-04-09,Unknown,519,4550,0,5069
2022-04-09,Total,74087,692751,457,767295
2022-04-10,Māori,13273,144060,83,157416
2022-04-10,Pacific peoples,3698,104171,72,107941
2022-04-10,Asian,8040,97537,26,105603
2022-04-10,"Middle Eastern, Latin American and African (MELAA)",1152,15048,6,16206
2022-04-10,European/other,44785,337569,282,382636
2022-04-10,Unknown,518,4608,0,5126
2022-04-10,Total,71466,702993,469,774928
2022-04-11,Māori,12475,146953,83,159511
2022-04-11,Pacific peoples,3541,104957,75,108573
2022-04-11,Asian,7647,99066,27,106740
2022-04-11,"Middle Eastern, Latin American and African (MELAA)",1140,15263,6,16409
2022-04-11,European/other,43116,346225,292,389633
2022-04-11,Unknown,481,4711,0,5192
2022-04-11,Total,68400,717175,483,786058
2022-04-12,Māori,11740,149325,85,161150
2022-04-12,Pacific peoples,3435,105552,78,109065
2022-04-12,Asian,7392,100396,27,107815
2022-04-12,"Middle Eastern, Latin American and African (MELAA)",1038,15503,6,16547
2022-04-12,European/other,41251,354232,300,395783
2022-04-12,Unknown,453,4792,1,5246
2022-04-12,Total,65309,729800,497,795606
2022-04-13,Māori,11184,151525,89,162798
2022-04-13,Pacific peoples,3306,106155,78,109539
2022-04-13,Asian,7103,101739,27,108869
2022-04-13,"Middle Eastern, Latin American and African (MELAA)",997,15703,7,16707
2022-04-13,European/other,40198,361515,312,402025
2022-04-13,Unknown,452,4849,1,5302
2022-04-13,Total,63240,741486,514,805240
2022-04-14,Māori,10581,153381,93,164055
2022-04-14,Pacific peoples,3151,106708,79,109938
2022-04-14,Asian,6843,102927,27,109797
2022-04-14,"Middle Eastern, Latin American and African (MELAA)",938,15881,7,16826
2022-04-14,European/other,39109,367648,327,407084
2022-04-14,Unknown,457,4912,1,5370
2022-04-14,Total,61079,751457,534,813070
2022-04-15,Māori,9723,155003,94,164820
2022-04-15,Pacific peoples,2990,107161,79,110230
2022-04-15,Asian,6567,103953,27,110547
2022-04-15,"Middle Eastern, Latin American and African (MELAA)",936,16001,7,16944
2022-04-15,European/other,37664,372928,335,410927
2022-04-15,Unknown,434,4979,1,5414
2022-04-15,Total,58314,760025,543,818882
2022-04-16,Māori,9430,156107,97,165634
2022-04-16,Pacific peoples,2939,107474,81,110494
2022-04-16,Asian,6525,104729,27,111281
2022-04-16,"Middle Eastern, Latin American and African (MELAA)",945,16088,7,17040
2022-04-16,European/other,37245,377362,341,414948
2022-04-16,Unknown,448,5021,1,5470
2022-04-16,Total,57532,766781,554,824867
2022-04-17,Māori,9075,157337,97,166509
2022-04-17,Pacific peoples,2805,107860,81,110746
2022-04-17,Asian,6412,105606,29,112047
2022-04-17,"Middle Eastern, Latin American and African (MELAA)",934,16201,7,17142
2022-04-17,European/other,36518,382328,349,419195
2022-04-17,Unknown,433,5076,1,5510
2022-04-17,Total,56177,774408,564,831149
2022-04-18,Māori,8202,159423,98,167723
2022-04-18,Pacific peoples,2528,108494,81,111103
2022-04-18,Asian,6328,106740,29,113097
2022-04-18,"Middle Eastern, Latin American and African (MELAA)",866,16404,7,17277
2022-04-18,European/other,35026,389309,354,424689
2022-04-18,Unknown,422,5143,1,5566
2022-04-18,Total,53372,785513,570,839455
2022-04-19,Māori,8366,161052,103,169521
2022-04-19,Pacific peoples,2624,108994,82,111700
2022-04-19,Asian,6730,107796,29,114555
2022-04-19,"Middle Eastern, Latin American and African (MELAA)",899,16540,7,17446
2022-04-19,European/other,36085,395431,360,431876
2022-04-19,Unknown,434,5214,1,5649
2022-04-19,Total,55138,795027,582,850747
2022-04-20,Māori,8283,162692,104,171079
2022-04-20,Pacific peoples,2700,109465,82,112247
2022-04-20,Asian,7003,108853,29,115885
2022-04-20,"Middle Eastern, Latin American and African (MELAA)",909,16700,7,17616
2022-04-20,European/other,36532,401661,377,438570
2022-04-20,Unknown,433,5287,1,5721
2022-04-20,Total,55860,804658,600,861118
2022-04-21,Māori,8475,163945,104,172524
2022-04-21,Pacific peoples,2761,109868,83,112712
2022-04-21,Asian,7391,109781,30,117202
2022-04-21,"Middle Eastern, Latin American and African (MELAA)",953,16820,7,17780
2022-04-21,European/other,37476,406705,385,444566
2022-04-21,Unknown,435,5371,1,5807
2022-04-21,Total,57491,812490,610,870591
2022-04-22,Māori,8908,164708,107,173723
2022-04-22,Pacific peoples,2939,110159,85,113183
2022-04-22,Asian,7816,110539,31,118386
2022-04-22,"Middle Eastern, Latin American and African (MELAA)",949,16938,7,17894
2022-04-22,European/other,38624,410534,396,449554
2022-04-22,Unknown,426,5408,1,5835
2022-04-22,Total,59662,818286,627,878575
2022-04-23,Māori,8738,165524,107,174369
2022-04-23,Pacific peoples,2985,110424,86,113495
2022-04-23,Asian,7932,111276,31,119239
2022-04-23,"Middle Eastern, Latin American and African (MELAA)",964,17034,7,18005
2022-04-23,European/other,38345,414553,404,453302
2022-04-23,Unknown,417,5461,1,5879
2022-04-23,Total,59381,824272,636,884289
2022-04-24,Māori,8583,166397,108,175088
2022-04-24,Pacific peoples,2979,110678,86,113743
2022-04-24,Asian,7923,112043,30,119996
2022-04-24,"Middle Eastern, Latin American and African (MELAA)",940,17136,7,18083
2022-04-24,European/other,38000,418801,412,457213
2022-04-24,Unknown,413,5502,1,5916
2022-04-24,Total,58838,830557,644,890039
2022-04-25,Māori,8155,167610,109,175874
2022-04-25,Pacific peoples,2924,111035,86,114045
2022-04-25,Asian,7781,113096,30,120907
2022-04-25,"Middle Eastern, Latin American and African (MELAA)",910,17272,7,18189
2022-04-25,European/other,36817,424291,416,461524
2022-04-25,Unknown,396,5559,1,5956
2022-04-25,Total,56983,838863,649,896495
2022-04-26,Māori,7726,169408,111,177245
2022-04-26,Pacific peoples,2847,111628,86,114561
2022-04-26,Asian,7624,114556,30,122210
2022-04-26,"Middle Eastern, Latin American and African (MELAA)",936,17443,7,18386
2022-04-26,European/other,36075,431461,436,467972
2022-04-26,Unknown,383,5639,1,6023
2022-04-26,Total,55591,850135,671,906397
2022-04-27,Māori,7300,170961,112,178373
2022-04-27,Pacific peoples,2763,112172,87,115022
2022-04-27,Asian,7570,115885,30,123485
2022-04-27,"Middle Eastern, Latin American and African (MELAA)",905,17614,7,18526
2022-04-27,European/other,35428,438141,446,474015
2022-04-27,Unknown,389,5711,1,6101
2022-04-27,Total,54355,860484,683,915522
2022-04-28,Māori,6852,172387,113,179352
2022-04-28,Pacific peoples,2674,112642,89,115405
2022-04-28,Asian,7520,117205,30,124755
2022-04-28,"Middle Eastern, Latin American and African (MELAA)",883,17779,7,18669
2022-04-28,European/other,34925,444140,456,479521
2022-04-28,Unknown,375,5769,1,6145
2022-04-28,Total,53229,869922,696,923847
2022-04-29,Māori,6523,172240,113,178876
2022-04-29,Pacific peoples,2560,112763,89,115412
2022-04-29,Asian,7351,118151,30,125532
2022-04-29,"Middle Eastern, Latin American and African (MELAA)",872,17823,7,18702
2022-04-29,European/other,34681,451109,462,486252
2022-04-29,Unknown,392,5802,1,6195
2022-04-29,Total,52379,877888,702,930969
2022-04-30,Māori,6531,171696,113,178340
2022-04-30,Pacific peoples,2483,112804,89,115376
2022-04-30,Asian,7373,118936,30,126339
2022-04-30,"Middle Eastern, Latin American and African (MELAA)",877,17900,7,18784
2022-04-30,European/other,34729,456417,467,491613
2022-04-30,Unknown,404,5840,1,6245
2022-04-30,Total,52397,883593,707,936697
2022-05-01,Māori,6554,172413,115,179082
2022-05-01,Pacific peoples,2539,113021,90,115650
2022-05-01,Asian,7606,119697,31,127334
2022-05-01,"Middle Eastern, Latin American and African (MELAA)",901,17980,7,18888
2022-05-01,European/other,35380,460336,468,496184
2022-05-01,Unknown,415,5873,2,6290
2022-05-01,Total,53395,889320,713,943428
2022-05-02,Māori,6994,173205,117,180316
2022-05-02,Pacific peoples,2793,113328,91,116212
2022-05-02,Asian,8040,120606,32,128678
2022-05-02,"Middle Eastern, Latin American and African (MELAA)",937,18086,7,19030
2022-05-02,European/other,36994,464644,482,502120
2022-05-02,Unknown,436,5903,2,6341
2022-05-02,Total,56194,895772,731,952697
2022-05-03,Māori,6643,174570,120,181333
2022-05-03,Pacific peoples,2646,113837,96,116579
2022-05-03,Asian,7893,121907,32,129832
2022-05-03,"Middle Eastern, Latin American and African (MELAA)",874,18281,7,19162
2022-05-03,European/other,36395,471085,496,507976
2022-05-03,Unknown,413,5965,2,6380
2022-05-03,Total,54864,905645,753,961262
2022-05-04,Māori,6547,175698,121,182366
2022-05-04,Pacific peoples,2590,114301,97,116988
2022-05-04,Asian,7871,123177,32,131080
2022-05-04,"Middle Eastern, Latin American and African (MELAA)",891,18419,7,19317
2022-05-04,European/other,36159,477108,516,513783
2022-05-04,Unknown,386,6038,1,6425
2022-05-04,Total,54444,914741,774,969959
2022-05-05,Māori,6410,176697,123,183230
2022-05-05,Pacific peoples,2559,114667,104,117330
2022-05-05,Asian,7720,124442,33,132195
2022-05-05,"Middle Eastern, Latin American and African (MELAA)",897,18559,7,19463
2022-05-05,European/other,35572,482582,529,518683
2022-05-05,Unknown,389,6089,1,6479
2022-05-05,Total,53547,923036,797,977380
2022-05-06,Māori,6371,177561,125,184057
2022-05-06,Pacific peoples,2542,115016,105,117663
2022-05-06,Asian,7696,125448,33,133177
2022-05-06,"Middle Eastern, Latin American and African (MELAA)",917,18663,7,19587
2022-05-06,European/other,35339,487324,537,523200
2022-05-06,Unknown,390,6143,1,6534
2022-05-06,Total,53255,930155,808,984218
2022-05-07,Māori,6340,178217,126,184683
2022-05-07,Pacific peoples,2569,115247,105,117921
2022-05-07,Asian,7715,126320,33,134068
2022-05-07,"Middle Eastern, Latin American and African (MELAA)",895,18781,7,19683
2022-05-07,European/other,35349,491119,538,527006
2022-05-07,Unknown,388,6196,1,6585
2022-05-07,Total,53256,935880,810,989946
2022-05-08,Māori,6290,178956,127,185373
2022-05-08,Pacific peoples,2540,115549,105,118194
2022-05-08,Asian,7605,127305,33,134943
2022-05-08,"Middle Eastern, Latin American and African (MELAA)",906,18882,7,19795
2022-05-08,European/other,35250,495673,539,531462
2022-05-08,Unknown,408,6241,1,6650
2022-05-08,Total,52999,942606,812,996417
2022-05-09,Māori,6569,179778,130,186477
2022-05-09,Pacific peoples,2670,115911,105,118686
2022-05-09,Asian,8036,128159,33,136228
2022-05-09,"Middle Eastern, Latin American and African (MELAA)",976,18980,7,19963
2022-05-09,European/other,37453,499614,550,537617
2022-05-09,Unknown,427,6275,1,6703
2022-05-09,Total,56131,948717,826,1005674
2022-05-10,Māori,6076,181198,135,187409
2022-05-10,Pacific peoples,2490,116477,106,119073
2022-05-10,Asian,7527,129807,34,137368
2022-05-10,"Middle Eastern, Latin American and African (MELAA)",942,19156,8,20106
2022-05-10,European/other,35014,507412,571,542997
2022-05-10,Unknown,433,6334,1,6768
2022-05-10,Total,52482,960384,855,1013721
2022-05-11,Māori,6126,182235,135,188496
2022-05-11,Pacific peoples,2535,116884,106,119525
2022-05-11,Asian,7742,131059,35,138836
2022-05-11,"Middle Eastern, Latin American and African (MELAA)",981,19310,8,20299
2022-05-11,European/other,35427,513212,578,549217
2022-05-11,Unknown,452,6379,1,6832
2022-05-11,Total,53263,969079,863,1023205
2022-05-12,Māori,6115,183094,139,189348
2022-05-12,Pacific peoples,2566,117225,112,119903
2022-05-12,Asian,7769,132173,37,139979
2022-05-12,"Middle Eastern, Latin American and African (MELAA)",969,19455,8,20432
2022-05-12,European/other,35486,518109,595,554190
2022-05-12,Unknown,453,6427,1,6881
2022-05-12,Total,53358,976483,892,1030733
2022-05-13,Māori,6085,183921,140,190146
2022-05-13,Pacific peoples,2576,117558,112,120246
2022-05-13,Asian,7907,133158,38,141103
2022-05-13,"Middle Eastern, Latin American and African (MELAA)",962,19579,8,20549
2022-05-13,European/other,35686,522591,610,558887
2022-05-13,Unknown,444,6479,1,6924
2022-05-13,Total,53660,983286,909,1037855
2022-05-14,Māori,6036,184547,141,190724
2022-05-14,Pacific peoples,2557,117819,112,120488
2022-05-14,Asian,7879,134047,39,141965
2022-05-14,"Middle Eastern, Latin American and African (MELAA)",965,19675,9,20649
2022-05-14,European/other,35862,526393,620,562875
2022-05-14,Unknown,456,6524,2,6982
2022-05-14,Total,53755,989005,923,1043683
2022-05-15,Māori,6091,185237,142,191470
2022-05-15,Pacific peoples,2592,118091,112,120795
2022-05-15,Asian,7984,134920,39,142943
2022-05-15,"Middle Eastern, Latin American and African (MELAA)",960,19787,9,20756
2022-05-15,European/other,36340,530844,625,567809
2022-05-15,Unknown,430,6592,2,7024
2022-05-15,Total,54397,995471,929,1050797
2022-05-16,Māori,6160,186339,142,192641
2022-05-16,Pacific peoples,2598,118582,112,121292
2022-05-16,Asian,8143,136205,40,144388
2022-05-16,"Middle Eastern, Latin American and African (MELAA)",990,19955,9,20954
2022-05-16,European/other,36703,537008,632,574343
2022-05-16,Unknown,448,6642,2,7092
2022-05-16,Total,55042,1004731,937,1060710
2022-05-17,Māori,6267,187267,147,193681
2022-05-17,Pacific peoples,2621,118962,116,121699
2022-05-17,Asian,8371,137339,41,145751
2022-05-17,"Middle Eastern, Latin American and African (MELAA)",1011,20098,9,21118
2022-05-17,European/other,37928,542368,652,580948
2022-05-17,Unknown,454,6720,2,7176
2022-05-17,Total,56652,1012754,967,1070373
2022-05-18,Māori,6185,188351,147,194683
2022-05-18,Pacific peoples,2566,119417,116,122099
2022-05-18,Asian,8338,138807,41,147186
2022-05-18,"Middle Eastern, Latin American and African (MELAA)",977,20291,9,21277
2022-05-18,European/other,37844,548570,658,587072
2022-05-18,Unknown,451,6787,2,7240
2022-05-18,Total,56361,1022223,973,1079557
2022-05-19,Māori,6155,189200,148,195503
2022-05-19,Pacific peoples,2562,119794,118,122474
2022-05-19,Asian,8417,139950,42,148409
2022-05-19,"Middle Eastern, Latin American and African (MELAA)",980,20424,9,21413
2022-05-19,European/other,38179,553534,671,592384
2022-05-19,Unknown,441,6840,2,7283
2022-05-19,Total,56734,1029742,990,1087466
2022-05-20,Māori,6046,189997,149,196192
2022-05-20,Pacific peoples,2497,120136,118,122751
2022-05-20,Asian,8280,141075,42,149397
2022-05-20,"Middle Eastern, Latin American and African (MELAA)",961,20544,9,21514
2022-05-20,European/other,38105,558233,677,597015
2022-05-20,Unknown,446,6875,2,7323
2022-05-20,Total,56335,1036860,997,1094192
2022-05-21,Māori,5951,190572,151,196674
2022-05-21,Pacific peoples,2434,120376,118,122928
2022-05-21,Asian,8184,141938,42,150164
2022-05-21,"Middle Eastern, Latin American and African (MELAA)",944,20643,9,21596
2022-05-21,European/other,37621,562215,685,600521
2022-05-21,Unknown,431,6934,2,7367
2022-05-21,Total,55565,1042678,1007,1099250
2022-05-22,Māori,5773,191317,151,197241
2022-05-22,Pacific peoples,2343,120682,118,123143
2022-05-22,Asian,8153,142917,42,151112
2022-05-22,"Middle Eastern, Latin American and African (MELAA)",924,20750,9,21683
2022-05-22,European/other,36893,567142,695,604730
2022-05-22,Unknown,431,6975,2,7408
2022-05-22,Total,54517,1049783,1017,1105317
2022-05-23,Māori,5505,192495,151,198151
2022-05-23,Pacific peoples,2223,121180,118,123521
2022-05-23,Asian,7866,144359,43,152268
2022-05-23,"Middle Eastern, Latin American and African (MELAA)",887,20949,9,21845
2022-05-23,European/other,36181,573688,708,610577
2022-05-23,Unknown,421,7043,2,7466
2022-05-23,Total,53083,1059714,1031,1113828
2022-05-24,Māori,5271,193533,152,198956
2022-05-24,Pacific peoples,2195,121591,118,123904
2022-05-24,Asian,7593,145726,43,153362
2022-05-24,"Middle Eastern, Latin American and African (MELAA)",868,21114,9,21991
2022-05-24,European/other,35337,580281,717,616335
2022-05-24,Unknown,415,7110,2,7527
2022-05-24,Total,51679,1069355,1041,1122075
2022-05-25,Māori,5081,194537,154,199772
2022-05-25,Pacific peoples,2146,121986,118,124250
2022-05-25,Asian,7229,147163,44,154436
2022-05-25,"Middle Eastern, Latin American and African (MELAA)",846,21271,9,22126
2022-05-25,European/other,34461,586393,730,621584
2022-05-25,Unknown,408,7171,2,7581
2022-05-25,Total,50171,1078521,1057,1129749
2022-05-26,Māori,4905,195352,158,200415
2022-05-26,Pacific peoples,2066,122354,121,124541
2022-05-26,Asian,7027,148391,44,155462
2022-05-26,"Middle Eastern, Latin American and African (MELAA)",838,21408,9,22255
2022-05-26,European/other,33970,591671,753,626394
2022-05-26,Unknown,423,7216,2,7641
2022-05-26,Total,49229,1086392,1087,1136708
2022-05-27,Māori,4862,196039,159,201060
2022-05-27,Pacific peoples,2036,122630,122,124788
2022-05-27,Asian,6996,149375,44,156415
2022-05-27,"Middle Eastern, Latin American and African (MELAA)",879,21507,9,22395
2022-05-27,European/other,33755,596291,762,630808
2022-05-27,Unknown,418,7260,2,7680
2022-05-27,Total,48946,1093102,1098,1143146
2022-05-28,Māori,4786,196520,162,201468
2022-05-28,Pacific peoples,2053,122807,122,124982
2022-05-28,Asian,6920,150143,44,157107
2022-05-28,"Middle Eastern, Latin American and African (MELAA)",888,21589,9,22486
2022-05-28,European/other,33724,599790,768,634282
2022-05-28,Unknown,415,7303,2,7720
2022-05-28,Total,48786,1098152,1107,1148045
2022-05-29,Māori,4746,197086,162,201994
2022-05-29,Pacific peoples,2053,123021,123,125197
2022-05-29,Asian,6807,151090,44,157941
2022-05-29,"Middle Eastern, Latin American and African (MELAA)",894,21678,9,22581
2022-05-29,European/other,33702,603994,772,638468
2022-05-29,Unknown,418,7345,2,7765
2022-05-29,Total,48620,1104214,1112,1153946
2022-05-30,Māori,4726,197996,163,202885
2022-05-30,Pacific peoples,2034,123398,124,125556
2022-05-30,Asian,6841,152248,44,159133
2022-05-30,"Middle Eastern, Latin American and African (MELAA)",874,21839,9,22722
2022-05-30,European/other,33773,609815,786,644374
2022-05-30,Unknown,422,7405,2,7829
2022-05-30,Total,48670,1112701,1128,1162499
2022-05-31,Māori,4727,198798,163,203688
2022-05-31,Pacific peoples,1960,123780,126,125866
2022-05-31,Asian,6875,153336,44,160255
2022-05-31,"Middle Eastern, Latin American and African (MELAA)",882,21986,9,22877
2022-05-31,European/other,33891,615561,796,650248
2022-05-31,Unknown,404,7475,2,7881
2022-05-31,Total,48739,1120936,1140,1170815
2022-06-01,Māori,4648,199610,165,204423
2022-06-01,Pacific peoples,1934,124129,127,126190
2022-06-01,Asian,6804,154407,44,161255
2022-06-01,"Middle Eastern, Latin American and African (MELAA)",880,22120,9,23009
2022-06-01,European/other,34398,620806,804,656008
2022-06-01,Unknown,400,7529,2,7931
2022-06-01,Total,49064,1128601,1151,1178816
2022-06-02,Māori,4660,200255,165,205080
2022-06-02,Pacific peoples,1894,124423,127,126444
2022-06-02,Asian,6693,155427,45,162165
2022-06-02,"Middle Eastern, Latin American and African (MELAA)",863,22248,9,23120
2022-06-02,European/other,33942,625614,815,660371
2022-06-02,Unknown,382,7587,2,7971
2022-06-02,Total,48434,1135554,1163,1185151
2022-06-03,Māori,4631,200902,164,205697
2022-06-03,Pacific peoples,1884,124676,127,126687
2022-06-03,Asian,6610,156379,48,163037
2022-06-03,"Middle Eastern, Latin American and African (MELAA)",840,22388,9,23237
2022-06-03,European/other,34055,630023,822,664900
2022-06-03,Unknown,372,7628,2,8002
2022-06-03,Total,48392,1141996,1172,1191560
2022-06-04,Māori,4598,201311,165,206074
2022-06-04,Pacific peoples,1839,124866,127,126832
2022-06-04,Asian,6553,157071,49,163673
2022-06-04,"Middle Eastern, Latin American and African (MELAA)",820,22479,9,23308
2022-06-04,European/other,33787,633495,827,668109
2022-06-04,Unknown,368,7667,2,8037
2022-06-04,Total,47965,1146889,1179,1196033
2022-06-06,Māori,4140,202718,167,207025
2022-06-06,Pacific peoples,1680,125436,127,127243
2022-06-06,Asian,5979,159091,49,165119
2022-06-06,"Middle Eastern, Latin American and African (MELAA)",756,22717,10,23483
2022-06-06,European/other,31022,643574,839,675435
2022-06-06,Unknown,326,7778,2,8106
2022-06-06,Total,43903,1161314,1194,1206411
2022-06-07,Māori,4083,203524,170,207777
2022-06-07,Pacific peoples,1633,125744,127,127504
2022-06-07,Asian,5831,160219,49,166099
2022-06-07,"Middle Eastern, Latin American and African (MELAA)",718,22868,10,23596
2022-06-07,European/other,30141,649432,858,680431
2022-06-07,Unknown,313,7824,2,8139
2022-06-07,Total,42719,1169611,1216,1213546
2022-06-08,Māori,4134,204257,171,208562
2022-06-08,Pacific peoples,1588,126066,128,127782
2022-06-08,Asian,5968,161226,50,167244
2022-06-08,"Middle Eastern, Latin American and African (MELAA)",729,22999,10,23738
2022-06-08,European/other,30157,655181,879,686217
2022-06-08,Unknown,309,7870,2,8181
2022-06-08,Total,42885,1177599,1240,1221724
2022-06-09,Māori,4076,204906,172,209154
2022-06-09,Pacific peoples,1606,126318,128,128052
2022-06-09,Asian,6038,162134,50,168222
2022-06-09,"Middle Eastern, Latin American and African (MELAA)",697,23110,10,23817
2022-06-09,European/other,30288,659542,885,690715
2022-06-09,Unknown,313,7912,2,8227
2022-06-09,Total,43018,1183922,1247,1228187
2022-06-10,Māori,3961,205527,172,209660
2022-06-10,Pacific peoples,1554,126561,129,128244
2022-06-10,Asian,5974,163003,50,169027
2022-06-10,"Middle Eastern, Latin American and African (MELAA)",669,23228,10,23907
2022-06-10,European/other,29385,664058,891,694334
2022-06-10,Unknown,341,7935,2,8278
2022-06-10,Total,41884,1190312,1254,1233450
2022-06-11,Māori,3973,205904,171,210048
2022-06-11,Pacific peoples,1584,126706,130,128420
2022-06-11,Asian,6048,163642,50,169740
2022-06-11,"Middle Eastern, Latin American and African (MELAA)",671,23299,10,23980
2022-06-11,European/other,29314,667266,898,697478
2022-06-11,Unknown,344,7967,2,8313
2022-06-11,Total,41934,1194784,1261,1237979
2022-06-12,Māori,3976,206294,173,210443
2022-06-12,Pacific peoples,1565,126872,130,128567
2022-06-12,Asian,6122,164238,51,170411
2022-06-12,"Middle Eastern, Latin American and African (MELAA)",648,23387,10,24045
2022-06-12,European/other,29310,670478,901,700689
2022-06-12,Unknown,343,7997,2,8342
2022-06-12,Total,41964,1199266,1267,1242497
2022-06-13,Māori,4085,206854,174,211113
2022-06-13,Pacific peoples,1539,127117,130,128786
2022-06-13,Asian,6249,165090,51,171390
2022-06-13,"Middle Eastern, Latin American and African (MELAA)",676,23472,10,24158
2022-06-13,European/other,29502,674582,919,705003
2022-06-13,Unknown,371,8029,2,8402
2022-06-13,Total,42422,1205144,1286,1248852
2022-06-14,Māori,3872,207622,174,211668
2022-06-14,Pacific peoples,1481,127384,130,128995
2022-06-14,Asian,6115,166079,51,172245
2022-06-14,"Middle Eastern, Latin American and African (MELAA)",666,23587,10,24263
2022-06-14,European/other,28421,679598,928,708947
2022-06-14,Unknown,370,8070,2,8442
2022-06-14,Total,40925,1212340,1295,1254560
2022-06-15,Māori,3648,208393,175,212216
2022-06-15,Pacific peoples,1408,127653,130,129191
2022-06-15,Asian,5853,167210,51,173114
2022-06-15,"Middle Eastern, Latin American and African (MELAA)",610,23730,10,24350
2022-06-15,European/other,26542,685321,940,712803
2022-06-15,Unknown,647,8118,2,8767
2022-06-15,Total,38708,1220425,1308,1260441
2022-06-16,Māori,3571,208984,175,212730
2022-06-16,Pacific peoples,1325,127922,131,129378
2022-06-16,Asian,5690,168188,51,173929
2022-06-16,"Middle Eastern, Latin American and African (MELAA)",610,23811,10,24431
2022-06-16,European/other,25444,689811,946,716201
2022-06-16,Unknown,622,8162,2,8786
2022-06-16,Total,37262,1226878,1315,1265455
2022-06-17,Māori,3482,209490,176,213148
2022-06-17,Pacific peoples,1324,128113,131,129568
2022-06-17,Asian,5588,168997,51,174636
2022-06-17,"Middle Eastern, Latin American and African (MELAA)",593,23900,10,24503
2022-06-17,European/other,24992,693426,954,719372
2022-06-17,Unknown,610,8200,2,8812
2022-06-17,Total,36589,1232126,1324,1270039
2022-06-18,Māori,3380,209878,177,213435
2022-06-18,Pacific peoples,1242,128288,132,129662
2022-06-18,Asian,5443,169708,51,175202
2022-06-18,"Middle Eastern, Latin American and African (MELAA)",570,23974,10,24554
2022-06-18,European/other,24169,696561,957,721687
2022-06-18,Unknown,614,8233,2,8849
2022-06-18,Total,35418,1236642,1329,1273389
2022-06-19,Māori,3347,210279,177,213803
2022-06-19,Pacific peoples,1207,128440,132,129779
2022-06-19,Asian,5437,170383,51,175871
2022-06-19,"Middle Eastern, Latin American and African (MELAA)",566,24041,10,24617
2022-06-19,European/other,23874,699790,965,724629
2022-06-19,Unknown,609,8258,2,8869
2022-06-19,Total,35040,1241191,1337,1277568
2022-06-20,Māori,3253,210944,179,214376
2022-06-20,Pacific peoples,1185,128652,134,129971
2022-06-20,Asian,5315,171354,52,176721
2022-06-20,"Middle Eastern, Latin American and African (MELAA)",560,24154,10,24724
2022-06-20,European/other,23664,704083,973,728720
2022-06-20,Unknown,614,8316,2,8932
2022-06-20,Total,34591,1247503,1350,1283444
2022-06-21,Māori,3250,211497,180,214927
2022-06-21,Pacific peoples,1163,128862,134,130159
2022-06-21,Asian,5327,172207,53,177587
2022-06-21,"Middle Eastern, Latin American and African (MELAA)",558,24257,10,24825
2022-06-21,European/other,23677,708016,989,732682
2022-06-21,Unknown,590,8356,2,8948
2022-06-21,Total,34565,1253195,1368,1289128
2022-06-22,Māori,3196,212045,182,215423
2022-06-22,Pacific peoples,1127,129063,135,130325
2022-06-22,Asian,5251,173093,53,178397
2022-06-22,"Middle Eastern, Latin American and African (MELAA)",551,24347,10,24908
2022-06-22,European/other,23747,711889,998,736634
2022-06-22,Unknown,312,8656,2,8970
2022-06-22,Total,34184,1259093,1380,1294657
