date,age_group,active,recovered,deceased,total
2020-11-05,0 to 9,3,79,0,82
2020-11-05,10 to 19,2,171,0,173
2020-11-05,20 to 29,15,447,0,462
2020-11-05,30 to 39,15,328,0,343
2020-11-05,40 to 49,15,262,0,277
2020-11-05,50 to 59,6,290,2,298
2020-11-05,60 to 69,10,197,3,210
2020-11-05,70 to 79,1,79,7,87
2020-11-05,80 to 89,0,24,8,32
2020-11-05,90+,0,4,5,9
2020-11-05,Total,67,1881,25,1973
2020-11-12,0 to 9,3,79,0,82
2020-11-12,10 to 19,5,171,0,176
2020-11-12,20 to 29,18,450,0,468
2020-11-12,30 to 39,7,338,0,345
2020-11-12,40 to 49,8,271,0,279
2020-11-12,50 to 59,4,294,2,300
2020-11-12,60 to 69,6,203,3,212
2020-11-12,70 to 79,2,79,7,88
2020-11-12,80 to 89,0,24,8,32
2020-11-12,90+,0,4,5,9
2020-11-12,Total,53,1913,25,1991
2020-11-26,0 to 9,1,81,0,82
2020-11-26,10 to 19,9,173,0,182
2020-11-26,20 to 29,17,467,0,484
2020-11-26,30 to 39,13,342,0,355
2020-11-26,40 to 49,10,276,0,286
2020-11-26,50 to 59,6,299,2,307
2020-11-26,60 to 69,2,209,3,214
2020-11-26,70 to 79,2,80,7,89
2020-11-26,80 to 89,0,24,8,32
2020-11-26,90+,0,4,5,9
2020-11-26,Total,60,1955,25,2040
2020-12-02,0 to 9,3,81,0,84
2020-12-02,10 to 19,11,174,0,185
2020-12-02,20 to 29,20,470,0,490
2020-12-02,30 to 39,15,346,0,361
2020-12-02,40 to 49,12,276,0,288
2020-12-02,50 to 59,6,299,2,307
2020-12-02,60 to 69,3,209,3,215
2020-12-02,70 to 79,2,80,7,89
2020-12-02,80 to 89,0,24,8,32
2020-12-02,90+,0,4,5,9
2020-12-02,Total,72,1963,25,2060
2020-12-09,0 to 9,4,81,0,85
2020-12-09,10 to 19,7,182,0,189
2020-12-09,20 to 29,14,483,0,497
2020-12-09,30 to 39,12,356,0,368
2020-12-09,40 to 49,9,281,0,290
2020-12-09,50 to 59,4,305,2,311
2020-12-09,60 to 69,3,211,3,217
2020-12-09,70 to 79,2,81,7,90
2020-12-09,80 to 89,0,24,8,32
2020-12-09,90+,0,4,5,9
2020-12-09,Total,55,2008,25,2088
2020-12-31,0 to 9,1,89,0,90
2020-12-31,10 to 19,4,190,0,194
2020-12-31,20 to 29,11,499,0,510
2020-12-31,30 to 39,15,375,0,390
2020-12-31,40 to 49,11,295,0,306
2020-12-31,50 to 59,9,307,2,318
2020-12-31,60 to 69,2,217,3,222
2020-12-31,70 to 79,2,82,7,91
2020-12-31,80 to 89,0,24,8,32
2020-12-31,90+,0,4,5,9
2020-12-31,Total,55,2082,25,2162
2021-01-10,0 to 9,6,89,0,95
2021-01-10,10 to 19,7,191,0,198
2021-01-10,20 to 29,20,506,0,526
2021-01-10,30 to 39,21,385,0,406
2021-01-10,40 to 49,11,304,0,315
2021-01-10,50 to 59,7,314,2,323
2021-01-10,60 to 69,1,219,3,223
2021-01-10,70 to 79,2,83,7,92
2021-01-10,80 to 89,0,24,8,32
2021-01-10,90+,0,4,5,9
2021-01-10,Total,75,2119,25,2219
2021-01-13,0 to 9,4,90,0,94
2021-01-13,10 to 19,7,192,0,199
2021-01-13,20 to 29,14,515,0,529
2021-01-13,30 to 39,17,392,0,409
2021-01-13,40 to 49,11,306,0,317
2021-01-13,50 to 59,7,315,2,324
2021-01-13,60 to 69,1,219,3,223
2021-01-13,70 to 79,1,84,7,92
2021-01-13,80 to 89,0,24,8,32
2021-01-13,90+,0,4,5,9
2021-01-13,Total,62,2141,25,2228
2021-01-24,0 to 9,7,91,0,98
2021-01-24,10 to 19,11,194,0,205
2021-01-24,20 to 29,15,526,0,541
2021-01-24,30 to 39,18,403,0,421
2021-01-24,40 to 49,16,311,0,327
2021-01-24,50 to 59,7,320,2,329
2021-01-24,60 to 69,4,221,3,228
2021-01-24,70 to 79,1,85,7,93
2021-01-24,80 to 89,0,24,8,32
2021-01-24,90+,0,4,5,9
2021-01-24,Total,79,2179,25,2283
2021-01-25,0 to 9,5,93,0,98
2021-01-25,10 to 19,9,196,0,205
2021-01-25,20 to 29,13,531,0,544
2021-01-25,30 to 39,17,407,0,424
2021-01-25,40 to 49,13,314,0,327
2021-01-25,50 to 59,3,323,2,328
2021-01-25,60 to 69,3,222,3,228
2021-01-25,70 to 79,1,85,7,93
2021-01-25,80 to 89,0,24,8,32
2021-01-25,90+,0,4,5,9
2021-01-25,Total,64,2199,25,2288
2021-02-04,0 to 9,8,94,0,102
2021-02-04,10 to 19,8,199,0,207
2021-02-04,20 to 29,7,538,0,545
2021-02-04,30 to 39,20,412,0,432
2021-02-04,40 to 49,12,321,0,333
2021-02-04,50 to 59,3,327,2,332
2021-02-04,60 to 69,1,224,3,228
2021-02-04,70 to 79,1,85,7,93
2021-02-04,80 to 89,0,24,8,32
2021-02-04,90+,0,4,5,9
2021-02-04,Total,60,2228,25,2313
2021-02-18,0 to 9,2,101,0,103
2021-02-18,10 to 19,8,205,0,213
2021-02-18,20 to 29,6,545,0,551
2021-02-18,30 to 39,15,427,0,442
2021-02-18,40 to 49,10,328,0,338
2021-02-18,50 to 59,3,329,3,335
2021-02-18,60 to 69,1,224,3,228
2021-02-18,70 to 79,1,85,7,93
2021-02-18,80 to 89,0,24,8,32
2021-02-18,90+,0,4,5,9
2021-02-18,Total,46,2272,26,2344
2021-02-21,0 to 9,3,101,0,104
2021-02-21,10 to 19,9,205,0,214
2021-02-21,20 to 29,8,545,0,553
2021-02-21,30 to 39,15,427,0,442
2021-02-21,40 to 49,11,328,0,339
2021-02-21,50 to 59,3,330,3,336
2021-02-21,60 to 69,1,224,3,228
2021-02-21,70 to 79,1,85,7,93
2021-02-21,80 to 89,0,24,8,32
2021-02-21,90+,0,4,5,9
2021-02-21,Total,51,2273,26,2350
2021-02-22,0 to 9,3,101,0,104
2021-02-22,10 to 19,10,205,0,215
2021-02-22,20 to 29,8,545,0,553
2021-02-22,30 to 39,15,429,0,444
2021-02-22,40 to 49,12,329,0,341
2021-02-22,50 to 59,3,331,3,337
2021-02-22,60 to 69,2,224,3,229
2021-02-22,70 to 79,1,85,7,93
2021-02-22,80 to 89,0,24,8,32
2021-02-22,90+,0,4,5,9
2021-02-22,Total,54,2277,26,2357
2021-02-28,0 to 9,4,102,0,106
2021-02-28,10 to 19,11,208,0,219
2021-02-28,20 to 29,12,546,0,558
2021-02-28,30 to 39,14,430,0,444
2021-02-28,40 to 49,15,330,0,345
2021-02-28,50 to 59,5,332,3,340
2021-02-28,60 to 69,3,224,3,230
2021-02-28,70 to 79,1,85,7,93
2021-02-28,80 to 89,0,24,8,32
2021-02-28,90+,0,4,5,9
2021-02-28,Total,65,2285,26,2376
2021-03-01,0 to 9,4,102,0,106
2021-03-01,10 to 19,11,208,0,219
2021-03-01,20 to 29,12,546,0,558
2021-03-01,30 to 39,15,430,0,445
2021-03-01,40 to 49,16,330,0,346
2021-03-01,50 to 59,5,332,3,340
2021-03-01,60 to 69,3,224,3,230
2021-03-01,70 to 79,1,85,7,93
2021-03-01,80 to 89,0,24,8,32
2021-03-01,90+,0,4,5,9
2021-03-01,Total,67,2285,26,2378
2021-03-02,0 to 9,4,102,0,106
2021-03-02,10 to 19,9,210,0,219
2021-03-02,20 to 29,15,546,0,561
2021-03-02,30 to 39,15,430,0,445
2021-03-02,40 to 49,16,330,0,346
2021-03-02,50 to 59,5,332,3,340
2021-03-02,60 to 69,4,224,3,231
2021-03-02,70 to 79,1,85,7,93
2021-03-02,80 to 89,0,24,8,32
2021-03-02,90+,0,4,5,9
2021-03-02,Total,69,2287,26,2382
2021-03-03,0 to 9,4,102,0,106
2021-03-03,10 to 19,8,211,0,219
2021-03-03,20 to 29,14,547,0,561
2021-03-03,30 to 39,13,433,0,446
2021-03-03,40 to 49,13,333,0,346
2021-03-03,50 to 59,5,332,3,340
2021-03-03,60 to 69,4,225,3,232
2021-03-03,70 to 79,1,85,7,93
2021-03-03,80 to 89,0,24,8,32
2021-03-03,90+,0,4,5,9
2021-03-03,Total,62,2296,26,2384
2021-03-08,0 to 9,5,102,0,107
2021-03-08,10 to 19,8,212,0,220
2021-03-08,20 to 29,24,549,0,573
2021-03-08,30 to 39,15,433,0,448
2021-03-08,40 to 49,12,336,0,348
2021-03-08,50 to 59,8,332,3,343
2021-03-08,60 to 69,5,224,3,232
2021-03-08,70 to 79,1,85,7,93
2021-03-08,80 to 89,0,24,8,32
2021-03-08,90+,0,4,5,9
2021-03-08,Total,78,2301,26,2405
2021-04-19,0 to 9,12,113,0,125
2021-04-19,10 to 19,5,222,0,227
2021-04-19,20 to 29,29,598,0,627
2021-04-19,30 to 39,33,486,0,519
2021-04-19,40 to 49,12,354,0,366
2021-04-19,50 to 59,6,351,3,360
2021-04-19,60 to 69,2,230,3,235
2021-04-19,70 to 79,2,86,7,95
2021-04-19,80 to 89,1,24,8,33
2021-04-19,90+,0,4,5,9
2021-04-19,Total,102,2468,26,2596
2021-05-24,0 to 9,3,129,0,132
2021-05-24,10 to 19,1,229,0,230
2021-05-24,20 to 29,5,634,0,639
2021-05-24,30 to 39,6,533,0,539
2021-05-24,40 to 49,3,373,0,376
2021-05-24,50 to 59,4,364,3,371
2021-05-24,60 to 69,1,235,3,239
2021-05-24,70 to 79,1,90,7,98
2021-05-24,80 to 89,0,26,8,34
2021-05-24,90+,0,4,5,9
2021-05-24,Total,24,2617,26,2667
2021-06-13,0 to 9,4,134,0,138
2021-06-13,10 to 19,1,232,0,233
2021-06-13,20 to 29,5,642,0,647
2021-06-13,30 to 39,11,543,0,554
2021-06-13,40 to 49,1,377,0,378
2021-06-13,50 to 59,4,369,3,376
2021-06-13,60 to 69,1,237,3,241
2021-06-13,70 to 79,0,91,7,98
2021-06-13,80 to 89,0,26,8,34
2021-06-13,90+,0,4,5,9
2021-06-13,Total,27,2655,26,2708
2021-06-29,0 to 9,5,138,0,143
2021-06-29,10 to 19,3,233,0,236
2021-06-29,20 to 29,9,648,0,657
2021-06-29,30 to 39,2,554,0,556
2021-06-29,40 to 49,6,380,0,386
2021-06-29,50 to 59,4,373,3,380
2021-06-29,60 to 69,1,238,3,242
2021-06-29,70 to 79,0,91,7,98
2021-06-29,80 to 89,0,26,8,34
2021-06-29,90+,0,4,5,9
2021-06-29,Total,30,2685,26,2741
2021-07-26,0 to 9,6,145,0,151
2021-07-26,10 to 19,0,239,0,239
2021-07-26,20 to 29,13,673,0,686
2021-07-26,30 to 39,11,579,0,590
2021-07-26,40 to 49,9,404,0,413
2021-07-26,50 to 59,11,383,3,397
2021-07-26,60 to 69,3,239,3,245
2021-07-26,70 to 79,1,91,7,99
2021-07-26,80 to 89,0,26,8,34
2021-07-26,90+,0,4,5,9
2021-07-26,Total,54,2783,26,2863
2021-08-19,0 to 9,5,155,0,160
2021-08-19,10 to 19,13,240,0,253
2021-08-19,20 to 29,15,693,0,708
2021-08-19,30 to 39,6,602,0,608
2021-08-19,40 to 49,5,420,0,425
2021-08-19,50 to 59,5,396,3,404
2021-08-19,60 to 69,4,244,3,251
2021-08-19,70 to 79,1,93,7,101
2021-08-19,80 to 89,1,26,8,35
2021-08-19,90+,0,4,5,9
2021-08-19,Total,55,2873,26,2954
2021-08-20,0 to 9,5,155,0,160
2021-08-20,10 to 19,17,240,0,257
2021-08-20,20 to 29,20,693,0,713
2021-08-20,30 to 39,6,602,0,608
2021-08-20,40 to 49,7,420,0,427
2021-08-20,50 to 59,7,396,3,406
2021-08-20,60 to 69,5,244,3,252
2021-08-20,70 to 79,1,93,7,101
2021-08-20,80 to 89,1,26,8,35
2021-08-20,90+,0,4,5,9
2021-08-20,Total,69,2873,26,2968
2021-08-21,0 to 9,7,155,0,162
2021-08-21,10 to 19,22,240,0,262
2021-08-21,20 to 29,27,693,0,720
2021-08-21,30 to 39,10,602,0,612
2021-08-21,40 to 49,7,420,0,427
2021-08-21,50 to 59,10,396,3,409
2021-08-21,60 to 69,7,244,3,254
2021-08-21,70 to 79,2,93,7,102
2021-08-21,80 to 89,1,26,8,35
2021-08-21,90+,0,4,5,9
2021-08-21,Total,93,2873,26,2992
2021-08-22,0 to 9,7,155,0,162
2021-08-22,10 to 19,26,240,0,266
2021-08-22,20 to 29,35,693,0,728
2021-08-22,30 to 39,10,602,0,612
2021-08-22,40 to 49,10,420,0,430
2021-08-22,50 to 59,15,396,3,414
2021-08-22,60 to 69,10,245,3,258
2021-08-22,70 to 79,2,93,7,102
2021-08-22,80 to 89,1,26,8,35
2021-08-22,90+,0,4,5,9
2021-08-22,Total,116,2874,26,3016
2021-08-23,0 to 9,12,155,0,167
2021-08-23,10 to 19,32,240,0,272
2021-08-23,20 to 29,45,693,0,738
2021-08-23,30 to 39,13,602,0,615
2021-08-23,40 to 49,15,420,0,435
2021-08-23,50 to 59,20,396,3,419
2021-08-23,60 to 69,13,245,3,261
2021-08-23,70 to 79,3,93,7,103
2021-08-23,80 to 89,1,26,8,35
2021-08-23,90+,0,4,5,9
2021-08-23,Total,154,2874,26,3054
2021-08-24,0 to 9,18,158,0,176
2021-08-24,10 to 19,38,245,0,283
2021-08-24,20 to 29,54,695,0,749
2021-08-24,30 to 39,15,603,0,618
2021-08-24,40 to 49,18,421,0,439
2021-08-24,50 to 59,22,397,3,422
2021-08-24,60 to 69,13,245,3,261
2021-08-24,70 to 79,4,93,7,104
2021-08-24,80 to 89,1,26,8,35
2021-08-24,90+,0,4,5,9
2021-08-24,Total,183,2887,26,3096
2021-08-25,0 to 9,26,158,0,184
2021-08-25,10 to 19,50,245,0,295
2021-08-25,20 to 29,73,695,0,768
2021-08-25,30 to 39,24,603,0,627
2021-08-25,40 to 49,25,421,0,446
2021-08-25,50 to 59,27,397,3,427
2021-08-25,60 to 69,13,245,3,261
2021-08-25,70 to 79,7,93,7,107
2021-08-25,80 to 89,1,26,8,35
2021-08-25,90+,0,4,5,9
2021-08-25,Total,246,2887,26,3159
2021-08-26,0 to 9,36,158,0,194
2021-08-26,10 to 19,65,245,0,310
2021-08-26,20 to 29,89,695,0,784
2021-08-26,30 to 39,27,603,0,630
2021-08-26,40 to 49,34,421,0,455
2021-08-26,50 to 59,39,397,3,439
2021-08-26,60 to 69,15,245,3,263
2021-08-26,70 to 79,8,93,7,108
2021-08-26,80 to 89,1,26,8,35
2021-08-26,90+,0,4,5,9
2021-08-26,Total,314,2887,26,3227
2021-08-28,0 to 9,51,158,0,209
2021-08-28,10 to 19,97,245,0,342
2021-08-28,20 to 29,122,695,0,817
2021-08-28,30 to 39,44,603,0,647
2021-08-28,40 to 49,55,421,0,476
2021-08-28,50 to 59,61,397,3,461
2021-08-28,60 to 69,23,245,3,271
2021-08-28,70 to 79,13,93,7,113
2021-08-28,80 to 89,1,26,8,35
2021-08-28,90+,0,4,5,9
2021-08-28,Total,467,2887,26,3380
2021-08-29,0 to 9,64,158,0,222
2021-08-29,10 to 19,119,245,0,364
2021-08-29,20 to 29,147,695,0,842
2021-08-29,30 to 39,50,603,0,653
2021-08-29,40 to 49,62,421,0,483
2021-08-29,50 to 59,65,397,3,465
2021-08-29,60 to 69,25,245,3,273
2021-08-29,70 to 79,16,93,7,116
2021-08-29,80 to 89,1,26,8,35
2021-08-29,90+,0,4,5,9
2021-08-29,Unknown,2,0,0,2
2021-08-29,Total,551,2887,26,3464
2021-08-30,0 to 9,77,158,0,235
2021-08-30,10 to 19,134,246,0,380
2021-08-30,20 to 29,156,697,0,853
2021-08-30,30 to 39,55,603,0,658
2021-08-30,40 to 49,65,421,0,486
2021-08-30,50 to 59,71,397,3,471
2021-08-30,60 to 69,27,245,3,275
2021-08-30,70 to 79,17,93,7,117
2021-08-30,80 to 89,1,26,8,35
2021-08-30,90+,0,4,5,9
2021-08-30,Unknown,0,0,0,0
2021-08-30,Total,603,2890,26,3519
2021-08-31,0 to 9,80,158,0,238
2021-08-31,10 to 19,158,246,0,404
2021-08-31,20 to 29,164,699,0,863
2021-08-31,30 to 39,58,603,0,661
2021-08-31,40 to 49,69,421,0,490
2021-08-31,50 to 59,76,397,3,476
2021-08-31,60 to 69,28,245,3,276
2021-08-31,70 to 79,17,93,7,117
2021-08-31,80 to 89,1,26,8,35
2021-08-31,90+,0,4,5,9
2021-08-31,Unknown,0,0,0,0
2021-08-31,Total,651,2892,26,3569
2021-09-01,0 to 9,92,158,0,250
2021-09-01,10 to 19,176,246,0,422
2021-09-01,20 to 29,185,702,0,887
2021-09-01,30 to 39,63,603,0,666
2021-09-01,40 to 49,74,421,0,495
2021-09-01,50 to 59,86,397,3,486
2021-09-01,60 to 69,28,245,3,276
2021-09-01,70 to 79,18,93,7,118
2021-09-01,80 to 89,1,26,8,35
2021-09-01,90+,1,4,5,10
2021-09-01,Unknown,0,0,0,0
2021-09-01,Total,724,2895,26,3645
2021-09-02,0 to 9,100,158,0,258
2021-09-02,10 to 19,185,246,0,431
2021-09-02,20 to 29,201,705,0,906
2021-09-02,30 to 39,68,604,0,672
2021-09-02,40 to 49,77,423,0,500
2021-09-02,50 to 59,90,397,3,490
2021-09-02,60 to 69,29,245,3,277
2021-09-02,70 to 79,18,93,7,118
2021-09-02,80 to 89,1,26,8,35
2021-09-02,90+,1,4,5,10
2021-09-02,Unknown,0,0,0,0
2021-09-02,Total,770,2901,26,3697
2021-09-03,0 to 9,102,162,0,264
2021-09-03,10 to 19,181,258,0,439
2021-09-03,20 to 29,193,719,0,912
2021-09-03,30 to 39,70,606,0,676
2021-09-03,40 to 49,76,428,0,504
2021-09-03,50 to 59,86,404,3,493
2021-09-03,60 to 69,28,247,3,278
2021-09-03,70 to 79,18,93,7,118
2021-09-03,80 to 89,0,27,8,35
2021-09-03,90+,1,4,5,10
2021-09-03,Unknown,0,0,0,0
2021-09-03,Total,755,2948,26,3729
2021-09-04,0 to 9,98,167,0,265
2021-09-04,10 to 19,177,265,0,442
2021-09-04,20 to 29,199,721,0,920
2021-09-04,30 to 39,71,607,0,678
2021-09-04,40 to 49,72,431,0,503
2021-09-04,50 to 59,86,407,3,496
2021-09-04,60 to 69,27,249,3,279
2021-09-04,70 to 79,20,93,7,120
2021-09-04,80 to 89,0,27,8,35
2021-09-04,90+,1,4,5,10
2021-09-04,Unknown,0,0,0,0
2021-09-04,Total,751,2971,26,3748
2021-09-05,0 to 9,101,169,0,270
2021-09-05,10 to 19,170,273,0,443
2021-09-05,20 to 29,199,729,0,928
2021-09-05,30 to 39,73,608,0,681
2021-09-05,40 to 49,69,436,0,505
2021-09-05,50 to 59,86,408,3,497
2021-09-05,60 to 69,25,251,3,279
2021-09-05,70 to 79,20,93,7,120
2021-09-05,80 to 89,0,27,8,35
2021-09-05,90+,0,4,6,10
2021-09-05,Unknown,0,0,0,0
2021-09-05,Total,743,2998,27,3768
2021-09-06,0 to 9,97,177,0,274
2021-09-06,10 to 19,159,287,0,446
2021-09-06,20 to 29,195,737,0,932
2021-09-06,30 to 39,75,612,0,687
2021-09-06,40 to 49,72,438,0,510
2021-09-06,50 to 59,85,409,3,497
2021-09-06,60 to 69,25,252,3,280
2021-09-06,70 to 79,21,93,7,121
2021-09-06,80 to 89,0,27,8,35
2021-09-06,90+,0,4,6,10
2021-09-06,Unknown,0,0,0,0
2021-09-06,Total,729,3036,27,3792
2021-09-07,0 to 9,102,180,0,282
2021-09-07,10 to 19,157,293,0,450
2021-09-07,20 to 29,188,750,0,938
2021-09-07,30 to 39,74,614,0,688
2021-09-07,40 to 49,74,438,0,512
2021-09-07,50 to 59,81,414,3,498
2021-09-07,60 to 69,24,253,3,280
2021-09-07,70 to 79,20,93,7,120
2021-09-07,80 to 89,0,27,8,35
2021-09-07,90+,0,4,6,10
2021-09-07,Unknown,0,0,0,0
2021-09-07,Total,720,3066,27,3813
2021-09-08,0 to 9,101,185,0,286
2021-09-08,10 to 19,137,315,0,452
2021-09-08,20 to 29,168,774,0,942
2021-09-08,30 to 39,67,622,0,689
2021-09-08,40 to 49,65,448,0,513
2021-09-08,50 to 59,79,418,3,500
2021-09-08,60 to 69,21,257,3,281
2021-09-08,70 to 79,20,94,7,121
2021-09-08,80 to 89,0,27,8,35
2021-09-08,90+,0,4,6,10
2021-09-08,Unknown,0,0,0,0
2021-09-08,Total,658,3144,27,3829
2021-09-09,0 to 9,98,194,0,292
2021-09-09,10 to 19,131,325,0,456
2021-09-09,20 to 29,160,786,0,946
2021-09-09,30 to 39,66,625,0,691
2021-09-09,40 to 49,56,457,0,513
2021-09-09,50 to 59,72,425,3,500
2021-09-09,60 to 69,23,257,3,283
2021-09-09,70 to 79,19,95,7,121
2021-09-09,80 to 89,0,27,8,35
2021-09-09,90+,0,4,6,10
2021-09-09,Unknown,0,0,0,0
2021-09-09,Total,625,3195,27,3847
2021-09-10,0 to 9,93,201,0,294
2021-09-10,10 to 19,127,334,0,461
2021-09-10,20 to 29,159,792,0,951
2021-09-10,30 to 39,70,625,0,695
2021-09-10,40 to 49,57,458,0,515
2021-09-10,50 to 59,69,429,3,501
2021-09-10,60 to 69,24,256,3,283
2021-09-10,70 to 79,18,96,7,121
2021-09-10,80 to 89,0,27,8,35
2021-09-10,90+,0,4,6,10
2021-09-10,Unknown,0,0,0,0
2021-09-10,Total,617,3222,27,3866
2021-09-11,0 to 9,102,201,0,303
2021-09-11,10 to 19,130,334,0,464
2021-09-11,20 to 29,161,793,0,954
2021-09-11,30 to 39,73,625,0,698
2021-09-11,40 to 49,60,458,0,518
2021-09-11,50 to 59,71,429,3,503
2021-09-11,60 to 69,25,256,3,284
2021-09-11,70 to 79,18,96,7,121
2021-09-11,80 to 89,0,27,8,35
2021-09-11,90+,0,4,6,10
2021-09-11,Unknown,0,0,0,0
2021-09-11,Total,640,3223,27,3890
2021-09-13,0 to 9,111,213,0,324
2021-09-13,10 to 19,121,356,0,477
2021-09-13,20 to 29,147,817,0,964
2021-09-13,30 to 39,68,635,0,703
2021-09-13,40 to 49,57,466,0,523
2021-09-13,50 to 59,70,434,3,507
2021-09-13,60 to 69,22,259,3,284
2021-09-13,70 to 79,18,97,7,122
2021-09-13,80 to 89,0,27,8,35
2021-09-13,90+,0,4,6,10
2021-09-13,Unknown,0,0,0,0
2021-09-13,Total,614,3308,27,3949
2021-09-14,0 to 9,115,218,0,333
2021-09-14,10 to 19,120,358,0,478
2021-09-14,20 to 29,144,824,0,968
2021-09-14,30 to 39,66,638,0,704
2021-09-14,40 to 49,57,467,0,524
2021-09-14,50 to 59,63,441,3,507
2021-09-14,60 to 69,21,260,3,284
2021-09-14,70 to 79,18,98,7,123
2021-09-14,80 to 89,0,27,8,35
2021-09-14,90+,0,4,6,10
2021-09-14,Unknown,0,0,0,0
2021-09-14,Total,604,3335,27,3966
2021-09-17,0 to 9,93,245,0,338
2021-09-17,10 to 19,116,378,0,494
2021-09-17,20 to 29,107,873,0,980
2021-09-17,30 to 39,55,655,0,710
2021-09-17,40 to 49,43,483,0,526
2021-09-17,50 to 59,43,464,3,510
2021-09-17,60 to 69,17,266,3,286
2021-09-17,70 to 79,15,103,7,125
2021-09-17,80 to 89,0,27,8,35
2021-09-17,90+,0,4,6,10
2021-09-17,Unknown,0,0,0,0
2021-09-17,Total,489,3498,27,4014
2021-09-18,0 to 9,83,260,0,343
2021-09-18,10 to 19,95,402,0,497
2021-09-18,20 to 29,97,893,0,990
2021-09-18,30 to 39,45,666,0,711
2021-09-18,40 to 49,41,487,0,528
2021-09-18,50 to 59,32,478,3,513
2021-09-18,60 to 69,12,271,3,286
2021-09-18,70 to 79,15,103,7,125
2021-09-18,80 to 89,0,27,8,35
2021-09-18,90+,0,4,6,10
2021-09-18,Unknown,0,0,0,0
2021-09-18,Total,420,3591,27,4038
2021-09-19,0 to 9,81,268,0,349
2021-09-19,10 to 19,88,412,0,500
2021-09-19,20 to 29,91,904,0,995
2021-09-19,30 to 39,46,668,0,714
2021-09-19,40 to 49,32,497,0,529
2021-09-19,50 to 59,27,483,3,513
2021-09-19,60 to 69,15,271,3,289
2021-09-19,70 to 79,13,105,7,125
2021-09-19,80 to 89,0,27,8,35
2021-09-19,90+,0,4,6,10
2021-09-19,Unknown,1,0,0,1
2021-09-19,Total,394,3639,27,4060
2021-09-21,0 to 9,74,282,0,356
2021-09-21,10 to 19,74,434,0,508
2021-09-21,20 to 29,73,929,0,1002
2021-09-21,30 to 39,34,683,0,717
2021-09-21,40 to 49,33,504,0,537
2021-09-21,50 to 59,16,496,3,515
2021-09-21,60 to 69,12,274,3,289
2021-09-21,70 to 79,9,110,7,126
2021-09-21,80 to 89,0,27,8,35
2021-09-21,90+,0,4,6,10
2021-09-21,Unknown,0,0,0,0
2021-09-21,Total,325,3743,27,4095
2021-09-22,0 to 9,71,292,0,363
2021-09-22,10 to 19,61,452,0,513
2021-09-22,20 to 29,69,938,0,1007
2021-09-22,30 to 39,29,688,0,717
2021-09-22,40 to 49,37,506,0,543
2021-09-22,50 to 59,14,498,3,515
2021-09-22,60 to 69,12,275,3,290
2021-09-22,70 to 79,8,111,7,126
2021-09-22,80 to 89,0,27,8,35
2021-09-22,90+,0,4,6,10
2021-09-22,Unknown,0,0,0,0
2021-09-22,Total,301,3791,27,4119
2021-09-23,0 to 9,67,300,0,367
2021-09-23,10 to 19,52,462,0,514
2021-09-23,20 to 29,68,941,0,1009
2021-09-23,30 to 39,29,690,0,719
2021-09-23,40 to 49,35,511,0,546
2021-09-23,50 to 59,18,497,3,518
2021-09-23,60 to 69,12,276,3,291
2021-09-23,70 to 79,8,111,7,126
2021-09-23,80 to 89,0,27,8,35
2021-09-23,90+,0,4,6,10
2021-09-23,Unknown,0,0,0,0
2021-09-23,Total,289,3819,27,4135
2021-09-24,0 to 9,55,315,0,370
2021-09-24,10 to 19,48,468,0,516
2021-09-24,20 to 29,58,952,0,1010
2021-09-24,30 to 39,26,693,0,719
2021-09-24,40 to 49,34,513,0,547
2021-09-24,50 to 59,17,498,3,518
2021-09-24,60 to 69,10,280,3,293
2021-09-24,70 to 79,8,111,7,126
2021-09-24,80 to 89,0,27,8,35
2021-09-24,90+,0,4,6,10
2021-09-24,Unknown,0,0,0,0
2021-09-24,Total,256,3861,27,4144
2021-09-25,0 to 9,46,325,0,371
2021-09-25,10 to 19,50,470,0,520
2021-09-25,20 to 29,58,956,0,1014
2021-09-25,30 to 39,25,699,0,724
2021-09-25,40 to 49,33,514,0,547
2021-09-25,50 to 59,20,499,3,522
2021-09-25,60 to 69,10,280,3,293
2021-09-25,70 to 79,8,111,7,126
2021-09-25,80 to 89,0,27,8,35
2021-09-25,90+,0,4,6,10
2021-09-25,Unknown,0,0,0,0
2021-09-25,Total,250,3885,27,4162
2021-09-26,0 to 9,40,333,0,373
2021-09-26,10 to 19,48,475,0,523
2021-09-26,20 to 29,49,969,0,1018
2021-09-26,30 to 39,22,705,0,727
2021-09-26,40 to 49,31,519,0,550
2021-09-26,50 to 59,18,505,3,526
2021-09-26,60 to 69,10,281,3,294
2021-09-26,70 to 79,6,113,7,126
2021-09-26,80 to 89,0,27,8,35
2021-09-26,90+,0,4,6,10
2021-09-26,Unknown,1,0,0,1
2021-09-26,Total,225,3931,27,4183
2021-09-27,0 to 9,44,333,0,377
2021-09-27,10 to 19,45,480,0,525
2021-09-27,20 to 29,46,975,0,1021
2021-09-27,30 to 39,22,706,0,728
2021-09-27,40 to 49,31,521,0,552
2021-09-27,50 to 59,17,505,3,525
2021-09-27,60 to 69,11,281,3,295
2021-09-27,70 to 79,6,113,7,126
2021-09-27,80 to 89,0,27,8,35
2021-09-27,90+,0,4,6,10
2021-09-27,Unknown,0,0,0,0
2021-09-27,Total,222,3945,27,4194
2021-09-28,0 to 9,42,337,0,379
2021-09-28,10 to 19,39,489,0,528
2021-09-28,20 to 29,45,975,0,1020
2021-09-28,30 to 39,22,707,0,729
2021-09-28,40 to 49,31,522,0,553
2021-09-28,50 to 59,20,506,3,529
2021-09-28,60 to 69,11,281,3,295
2021-09-28,70 to 79,6,113,7,126
2021-09-28,80 to 89,0,27,8,35
2021-09-28,90+,0,4,6,10
2021-09-28,Unknown,0,0,0,0
2021-09-28,Total,216,3961,27,4204
2021-09-29,0 to 9,57,338,0,395
2021-09-29,10 to 19,43,489,0,532
2021-09-29,20 to 29,56,975,0,1031
2021-09-29,30 to 39,26,707,0,733
2021-09-29,40 to 49,35,523,0,558
2021-09-29,50 to 59,22,506,3,531
2021-09-29,60 to 69,12,282,3,297
2021-09-29,70 to 79,5,114,7,126
2021-09-29,80 to 89,0,27,8,35
2021-09-29,90+,0,4,6,10
2021-09-29,Unknown,0,0,0,0
2021-09-29,Total,256,3965,27,4248
2021-09-30,0 to 9,57,341,0,398
2021-09-30,10 to 19,46,492,0,538
2021-09-30,20 to 29,59,976,0,1035
2021-09-30,30 to 39,27,708,0,735
2021-09-30,40 to 49,40,524,0,564
2021-09-30,50 to 59,25,506,3,534
2021-09-30,60 to 69,12,282,3,297
2021-09-30,70 to 79,5,114,7,126
2021-09-30,80 to 89,0,27,8,35
2021-09-30,90+,1,4,6,11
2021-09-30,Unknown,0,0,0,0
2021-09-30,Total,272,3974,27,4273
2021-10-01,0 to 9,57,345,0,402
2021-10-01,10 to 19,46,495,0,541
2021-10-01,20 to 29,63,979,0,1042
2021-10-01,30 to 39,27,709,0,736
2021-10-01,40 to 49,41,525,0,566
2021-10-01,50 to 59,26,506,3,535
2021-10-01,60 to 69,11,283,3,297
2021-10-01,70 to 79,3,116,7,126
2021-10-01,80 to 89,0,27,8,35
2021-10-01,90+,1,4,6,11
2021-10-01,Unknown,0,0,0,0
2021-10-01,Total,275,3989,27,4291
2021-10-02,0 to 9,47,360,0,407
2021-10-02,10 to 19,42,506,0,548
2021-10-02,20 to 29,44,1001,0,1045
2021-10-02,30 to 39,31,712,0,743
2021-10-02,40 to 49,33,534,0,567
2021-10-02,50 to 59,29,507,3,539
2021-10-02,60 to 69,10,285,3,298
2021-10-02,70 to 79,2,117,7,126
2021-10-02,80 to 89,0,27,8,35
2021-10-02,90+,1,4,6,11
2021-10-02,Unknown,0,0,0,0
2021-10-02,Total,239,4053,27,4319
2021-10-03,0 to 9,51,360,0,411
2021-10-03,10 to 19,43,510,0,553
2021-10-03,20 to 29,48,1003,0,1051
2021-10-03,30 to 39,36,712,0,748
2021-10-03,40 to 49,39,536,0,575
2021-10-03,50 to 59,32,508,3,543
2021-10-03,60 to 69,10,285,3,298
2021-10-03,70 to 79,3,117,7,127
2021-10-03,80 to 89,0,27,8,35
2021-10-03,90+,1,4,6,11
2021-10-03,Unknown,0,0,0,0
2021-10-03,Total,263,4062,27,4352
2021-10-04,0 to 9,57,360,0,417
2021-10-04,10 to 19,46,511,0,557
2021-10-04,20 to 29,51,1004,0,1055
2021-10-04,30 to 39,41,712,0,753
2021-10-04,40 to 49,42,537,0,579
2021-10-04,50 to 59,36,509,3,548
2021-10-04,60 to 69,10,287,3,300
2021-10-04,70 to 79,3,117,7,127
2021-10-04,80 to 89,0,27,8,35
2021-10-04,90+,1,4,6,11
2021-10-04,Unknown,0,0,0,0
2021-10-04,Total,287,4068,27,4382
2021-10-05,0 to 9,57,360,0,417
2021-10-05,10 to 19,48,511,0,559
2021-10-05,20 to 29,54,1005,0,1059
2021-10-05,30 to 39,46,714,0,760
2021-10-05,40 to 49,47,538,0,585
2021-10-05,50 to 59,43,509,3,555
2021-10-05,60 to 69,9,288,3,300
2021-10-05,70 to 79,3,117,7,127
2021-10-05,80 to 89,0,27,8,35
2021-10-05,90+,1,4,6,11
2021-10-05,Unknown,0,0,0,0
2021-10-05,Total,308,4073,27,4408
2021-10-06,0 to 9,60,360,0,420
2021-10-06,10 to 19,52,511,0,563
2021-10-06,20 to 29,62,1005,0,1067
2021-10-06,30 to 39,58,714,0,772
2021-10-06,40 to 49,54,538,0,592
2021-10-06,50 to 59,48,509,3,560
2021-10-06,60 to 69,12,288,3,303
2021-10-06,70 to 79,3,117,7,127
2021-10-06,80 to 89,0,27,8,35
2021-10-06,90+,1,4,6,11
2021-10-06,Unknown,0,0,0,0
2021-10-06,Total,350,4073,27,4450
2021-10-07,0 to 9,63,361,0,424
2021-10-07,10 to 19,56,511,0,567
2021-10-07,20 to 29,68,1006,0,1074
2021-10-07,30 to 39,62,716,0,778
2021-10-07,40 to 49,60,538,0,598
2021-10-07,50 to 59,51,509,3,563
2021-10-07,60 to 69,12,288,3,303
2021-10-07,70 to 79,3,117,7,127
2021-10-07,80 to 89,0,27,8,35
2021-10-07,90+,1,4,6,11
2021-10-07,Unknown,0,0,0,0
2021-10-07,Total,376,4077,27,4480
2021-10-08,0 to 9,74,361,0,435
2021-10-08,10 to 19,61,511,0,572
2021-10-08,20 to 29,75,1006,0,1081
2021-10-08,30 to 39,72,716,0,788
2021-10-08,40 to 49,65,539,0,604
2021-10-08,50 to 59,58,508,4,570
2021-10-08,60 to 69,12,288,3,303
2021-10-08,70 to 79,4,117,7,128
2021-10-08,80 to 89,0,27,8,35
2021-10-08,90+,1,4,6,11
2021-10-08,Unknown,0,0,0,0
2021-10-08,Total,422,4077,28,4527
2021-10-09,0 to 9,73,368,0,441
2021-10-09,10 to 19,59,519,0,578
2021-10-09,20 to 29,77,1008,0,1085
2021-10-09,30 to 39,71,724,0,795
2021-10-09,40 to 49,60,547,0,607
2021-10-09,50 to 59,61,512,4,577
2021-10-09,60 to 69,14,289,3,306
2021-10-09,70 to 79,3,118,7,128
2021-10-09,80 to 89,0,27,8,35
2021-10-09,90+,1,4,6,11
2021-10-09,Unknown,0,0,0,0
2021-10-09,Total,419,4116,28,4563
2021-10-10,0 to 9,76,372,0,448
2021-10-10,10 to 19,60,524,0,584
2021-10-10,20 to 29,80,1014,0,1094
2021-10-10,30 to 39,79,728,0,807
2021-10-10,40 to 49,73,551,0,624
2021-10-10,50 to 59,67,512,4,583
2021-10-10,60 to 69,16,289,3,308
2021-10-10,70 to 79,3,119,7,129
2021-10-10,80 to 89,0,27,8,35
2021-10-10,90+,2,4,6,12
2021-10-10,Unknown,0,0,0,0
2021-10-10,Total,456,4140,28,4624
2021-10-11,0 to 9,75,378,0,453
2021-10-11,10 to 19,61,527,0,588
2021-10-11,20 to 29,83,1017,0,1100
2021-10-11,30 to 39,83,732,0,815
2021-10-11,40 to 49,77,553,0,630
2021-10-11,50 to 59,69,515,4,588
2021-10-11,60 to 69,17,289,3,309
2021-10-11,70 to 79,2,120,7,129
2021-10-11,80 to 89,0,27,8,35
2021-10-11,90+,2,4,6,12
2021-10-11,Unknown,0,0,0,0
2021-10-11,Total,469,4162,28,4659
2021-10-12,0 to 9,78,383,0,461
2021-10-12,10 to 19,64,530,0,594
2021-10-12,20 to 29,86,1023,0,1109
2021-10-12,30 to 39,94,733,0,827
2021-10-12,40 to 49,81,554,0,635
2021-10-12,50 to 59,71,517,4,592
2021-10-12,60 to 69,17,290,3,310
2021-10-12,70 to 79,2,120,7,129
2021-10-12,80 to 89,0,27,8,35
2021-10-12,90+,1,5,6,12
2021-10-12,Unknown,0,0,0,0
2021-10-12,Total,494,4182,28,4704
2021-10-13,0 to 9,91,383,0,474
2021-10-13,10 to 19,72,531,0,603
2021-10-13,20 to 29,91,1023,0,1114
2021-10-13,30 to 39,110,733,0,843
2021-10-13,40 to 49,88,554,0,642
2021-10-13,50 to 59,72,518,4,594
2021-10-13,60 to 69,18,290,3,311
2021-10-13,70 to 79,3,120,7,130
2021-10-13,80 to 89,1,27,8,36
2021-10-13,90+,1,5,6,12
2021-10-13,Unknown,0,0,0,0
2021-10-13,Total,547,4184,28,4759
2021-10-14,0 to 9,103,383,0,486
2021-10-14,10 to 19,89,531,0,620
2021-10-14,20 to 29,106,1023,0,1129
2021-10-14,30 to 39,124,733,0,857
2021-10-14,40 to 49,94,555,0,649
2021-10-14,50 to 59,77,519,4,600
2021-10-14,60 to 69,18,290,3,311
2021-10-14,70 to 79,3,120,7,130
2021-10-14,80 to 89,2,27,8,37
2021-10-14,90+,1,5,6,12
2021-10-14,Unknown,0,0,0,0
2021-10-14,Total,617,4186,28,4831
2021-10-15,0 to 9,113,383,0,496
2021-10-15,10 to 19,96,531,0,627
2021-10-15,20 to 29,115,1023,0,1138
2021-10-15,30 to 39,140,733,0,873
2021-10-15,40 to 49,108,555,0,663
2021-10-15,50 to 59,83,519,4,606
2021-10-15,60 to 69,21,290,3,314
2021-10-15,70 to 79,4,120,7,131
2021-10-15,80 to 89,2,27,8,37
2021-10-15,90+,1,5,6,12
2021-10-15,Unknown,0,0,0,0
2021-10-15,Total,683,4186,28,4897
2021-10-16,0 to 9,108,393,0,501
2021-10-16,10 to 19,83,545,0,628
2021-10-16,20 to 29,115,1036,0,1151
2021-10-16,30 to 39,138,740,0,878
2021-10-16,40 to 49,107,562,0,669
2021-10-16,50 to 59,83,527,4,614
2021-10-16,60 to 69,23,291,3,317
2021-10-16,70 to 79,5,120,7,132
2021-10-16,80 to 89,2,27,8,37
2021-10-16,90+,1,5,6,12
2021-10-16,Unknown,0,0,0,0
2021-10-16,Total,665,4246,28,4939
2021-10-17,0 to 9,97,406,0,503
2021-10-17,10 to 19,81,552,0,633
2021-10-17,20 to 29,113,1050,0,1163
2021-10-17,30 to 39,142,756,0,898
2021-10-17,40 to 49,97,576,0,673
2021-10-17,50 to 59,80,535,4,619
2021-10-17,60 to 69,24,294,3,321
2021-10-17,70 to 79,5,120,7,132
2021-10-17,80 to 89,2,27,8,37
2021-10-17,90+,1,5,6,12
2021-10-17,Unknown,0,0,0,0
2021-10-17,Total,642,4321,28,4991
2021-10-18,0 to 9,98,415,0,513
2021-10-18,10 to 19,85,559,0,644
2021-10-18,20 to 29,119,1058,0,1177
2021-10-18,30 to 39,145,772,0,917
2021-10-18,40 to 49,97,583,0,680
2021-10-18,50 to 59,77,540,4,621
2021-10-18,60 to 69,25,294,3,322
2021-10-18,70 to 79,4,121,7,132
2021-10-18,80 to 89,1,28,8,37
2021-10-18,90+,1,5,6,12
2021-10-18,Unknown,0,0,0,0
2021-10-18,Total,652,4375,28,5055
2021-10-19,0 to 9,111,415,0,526
2021-10-19,10 to 19,99,560,0,659
2021-10-19,20 to 29,133,1059,0,1192
2021-10-19,30 to 39,165,775,0,940
2021-10-19,40 to 49,110,588,0,698
2021-10-19,50 to 59,79,544,4,627
2021-10-19,60 to 69,30,294,3,327
2021-10-19,70 to 79,7,121,7,135
2021-10-19,80 to 89,1,28,8,37
2021-10-19,90+,1,5,6,12
2021-10-19,Unknown,0,0,0,0
2021-10-19,Total,736,4389,28,5153
2021-10-20,0 to 9,116,415,0,531
2021-10-20,10 to 19,108,560,0,668
2021-10-20,20 to 29,145,1059,0,1204
2021-10-20,30 to 39,179,778,0,957
2021-10-20,40 to 49,113,590,0,703
2021-10-20,50 to 59,83,545,4,632
2021-10-20,60 to 69,36,294,3,333
2021-10-20,70 to 79,8,121,7,136
2021-10-20,80 to 89,1,28,8,37
2021-10-20,90+,1,5,6,12
2021-10-20,Unknown,0,0,0,0
2021-10-20,Total,790,4395,28,5213
2021-10-21,0 to 9,138,415,0,553
2021-10-21,10 to 19,126,560,0,686
2021-10-21,20 to 29,162,1059,0,1221
2021-10-21,30 to 39,202,778,0,980
2021-10-21,40 to 49,124,590,0,714
2021-10-21,50 to 59,90,545,4,639
2021-10-21,60 to 69,38,295,3,336
2021-10-21,70 to 79,9,121,7,137
2021-10-21,80 to 89,1,28,8,37
2021-10-21,90+,1,5,6,12
2021-10-21,Unknown,0,0,0,0
2021-10-21,Total,891,4396,28,5315
2021-10-22,0 to 9,160,416,0,575
2021-10-22,10 to 19,140,560,0,701
2021-10-22,20 to 29,193,1059,0,1252
2021-10-22,30 to 39,226,779,0,1005
2021-10-22,40 to 49,140,594,0,734
2021-10-22,50 to 59,102,545,4,651
2021-10-22,60 to 69,42,295,3,340
2021-10-22,70 to 79,13,121,7,141
2021-10-22,80 to 89,2,28,8,38
2021-10-22,90+,1,5,6,12
2021-10-22,Unknown,0,0,0,0
2021-10-22,Total,1019,4402,28,5449
2021-10-23,0 to 9,180,415,0,595
2021-10-23,10 to 19,150,560,0,710
2021-10-23,20 to 29,217,1060,0,1277
2021-10-23,30 to 39,249,782,0,1031
2021-10-23,40 to 49,147,596,0,743
2021-10-23,50 to 59,111,545,4,660
2021-10-23,60 to 69,48,295,3,346
2021-10-23,70 to 79,14,121,7,142
2021-10-23,80 to 89,2,28,8,38
2021-10-23,90+,1,5,6,12
2021-10-23,Unknown,0,0,0,0
2021-10-23,Total,1119,4407,28,5554
2021-10-25,0 to 9,199,425,0,624
2021-10-25,10 to 19,168,569,0,737
2021-10-25,20 to 29,244,1071,0,1315
2021-10-25,30 to 39,289,792,0,1081
2021-10-25,40 to 49,162,604,0,766
2021-10-25,50 to 59,124,554,4,682
2021-10-25,60 to 69,51,296,3,350
2021-10-25,70 to 79,14,121,7,142
2021-10-25,80 to 89,4,28,8,40
2021-10-25,90+,1,5,6,12
2021-10-25,Unknown,0,0,0,0
2021-10-25,Total,1256,4465,28,5749
2021-10-26,0 to 9,206,436,0,642
2021-10-26,10 to 19,159,583,0,742
2021-10-26,20 to 29,239,1088,0,1327
2021-10-26,30 to 39,280,811,0,1091
2021-10-26,40 to 49,162,613,0,775
2021-10-26,50 to 59,121,573,4,698
2021-10-26,60 to 69,47,303,3,353
2021-10-26,70 to 79,14,121,7,142
2021-10-26,80 to 89,3,29,8,40
2021-10-26,90+,1,5,6,12
2021-10-26,Unknown,0,0,0,0
2021-10-26,Total,1232,4562,28,5822
2021-10-27,0 to 9,213,437,0,650
2021-10-27,10 to 19,165,585,0,750
2021-10-27,20 to 29,253,1089,0,1342
2021-10-27,30 to 39,300,812,0,1112
2021-10-27,40 to 49,174,613,0,787
2021-10-27,50 to 59,129,573,4,706
2021-10-27,60 to 69,50,303,3,356
2021-10-27,70 to 79,16,121,7,144
2021-10-27,80 to 89,3,29,8,40
2021-10-27,90+,1,5,6,12
2021-10-27,Unknown,0,0,0,0
2021-10-27,Total,1304,4567,28,5899
2021-10-28,0 to 9,224,437,0,661
2021-10-28,10 to 19,177,585,0,762
2021-10-28,20 to 29,276,1090,0,1366
2021-10-28,30 to 39,319,816,0,1135
2021-10-28,40 to 49,182,614,0,796
2021-10-28,50 to 59,142,574,4,720
2021-10-28,60 to 69,52,303,3,358
2021-10-28,70 to 79,16,121,7,144
2021-10-28,80 to 89,4,29,8,41
2021-10-28,90+,1,5,6,12
2021-10-28,Unknown,0,0,0,0
2021-10-28,Total,1393,4574,28,5995
2021-10-29,0 to 9,251,437,0,688
2021-10-29,10 to 19,197,585,0,782
2021-10-29,20 to 29,293,1091,0,1384
2021-10-29,30 to 39,341,820,0,1161
2021-10-29,40 to 49,197,615,0,812
2021-10-29,50 to 59,154,574,4,732
2021-10-29,60 to 69,58,303,3,364
2021-10-29,70 to 79,17,121,7,145
2021-10-29,80 to 89,6,29,8,43
2021-10-29,90+,1,5,6,12
2021-10-29,Unknown,1,0,0,1
2021-10-29,Total,1516,4580,28,6124
2021-10-30,0 to 9,273,438,0,711
2021-10-30,10 to 19,214,585,0,799
2021-10-30,20 to 29,326,1093,0,1419
2021-10-30,30 to 39,377,821,0,1198
2021-10-30,40 to 49,220,615,0,835
2021-10-30,50 to 59,173,575,4,752
2021-10-30,60 to 69,62,303,3,368
2021-10-30,70 to 79,18,121,7,146
2021-10-30,80 to 89,7,29,8,44
2021-10-30,90+,1,5,6,12
2021-10-30,Unknown,1,0,0,1
2021-10-30,Total,1672,4585,28,6285
2021-10-31,0 to 9,292,448,0,740
2021-10-31,10 to 19,222,595,0,817
2021-10-31,20 to 29,342,1105,0,1447
2021-10-31,30 to 39,380,837,0,1217
2021-10-31,40 to 49,228,624,0,852
2021-10-31,50 to 59,183,579,4,766
2021-10-31,60 to 69,69,303,3,375
2021-10-31,70 to 79,23,121,7,151
2021-10-31,80 to 89,13,29,8,50
2021-10-31,90+,1,6,6,13
2021-10-31,Unknown,0,0,0,0
2021-10-31,Total,1753,4647,28,6428
2021-11-01,0 to 9,318,449,0,767
2021-11-01,10 to 19,250,595,0,845
2021-11-01,20 to 29,373,1105,0,1478
2021-11-01,30 to 39,418,838,0,1256
2021-11-01,40 to 49,243,625,0,868
2021-11-01,50 to 59,198,579,4,781
2021-11-01,60 to 69,77,303,3,383
2021-11-01,70 to 79,25,121,7,153
2021-11-01,80 to 89,13,29,8,50
2021-11-01,90+,1,6,6,13
2021-11-01,Unknown,0,0,0,0
2021-11-01,Total,1916,4650,28,6594
2021-11-02,0 to 9,309,474,0,783
2021-11-02,10 to 19,260,600,0,860
2021-11-02,20 to 29,378,1124,0,1502
2021-11-02,30 to 39,439,848,0,1287
2021-11-02,40 to 49,254,634,0,888
2021-11-02,50 to 59,202,590,4,796
2021-11-02,60 to 69,82,304,3,389
2021-11-02,70 to 79,25,122,7,154
2021-11-02,80 to 89,14,29,8,51
2021-11-02,90+,1,6,6,13
2021-11-02,Unknown,0,0,0,0
2021-11-02,Total,1964,4731,28,6723
2021-11-03,0 to 9,329,476,0,805
2021-11-03,10 to 19,273,602,0,875
2021-11-03,20 to 29,397,1124,0,1521
2021-11-03,30 to 39,456,849,0,1305
2021-11-03,40 to 49,263,638,0,901
2021-11-03,50 to 59,212,592,4,808
2021-11-03,60 to 69,89,304,3,396
2021-11-03,70 to 79,27,122,7,156
2021-11-03,80 to 89,15,29,8,52
2021-11-03,90+,1,6,6,13
2021-11-03,Unknown,0,0,0,0
2021-11-03,Total,2062,4742,28,6832
2021-11-05,0 to 9,370,479,0,849
2021-11-05,10 to 19,311,605,0,916
2021-11-05,20 to 29,454,1128,0,1582
2021-11-05,30 to 39,517,858,0,1375
2021-11-05,40 to 49,291,644,1,936
2021-11-05,50 to 59,234,596,4,834
2021-11-05,60 to 69,111,305,3,419
2021-11-05,70 to 79,28,123,7,158
2021-11-05,80 to 89,17,29,8,54
2021-11-05,90+,3,6,6,15
2021-11-05,Unknown,0,0,0,0
2021-11-05,Total,2336,4773,29,7138
2021-11-11,0 to 9,512,505,0,1017
2021-11-11,10 to 19,451,635,0,1086
2021-11-11,20 to 29,616,1171,0,1787
2021-11-11,30 to 39,626,908,0,1534
2021-11-11,40 to 49,383,671,2,1056
2021-11-11,50 to 59,306,616,5,927
2021-11-11,60 to 69,132,318,4,454
2021-11-11,70 to 79,41,123,7,171
2021-11-11,80 to 89,20,30,9,59
2021-11-11,90+,4,6,6,16
2021-11-11,Unknown,0,0,0,0
2021-11-11,Total,3091,4983,33,8107
2021-11-15,0 to 9,630,528,0,1158
2021-11-15,10 to 19,576,662,0,1238
2021-11-15,20 to 29,749,1211,0,1960
2021-11-15,30 to 39,694,959,0,1653
2021-11-15,40 to 49,427,703,2,1132
2021-11-15,50 to 59,341,632,5,978
2021-11-15,60 to 69,160,320,4,484
2021-11-15,70 to 79,52,123,7,182
2021-11-15,80 to 89,22,32,9,63
2021-11-15,90+,4,6,7,17
2021-11-15,Unknown,1,0,0,1
2021-11-15,Total,3656,5176,34,8866
2021-11-17,0 to 9,717,531,0,1248
2021-11-17,10 to 19,647,663,0,1310
2021-11-17,20 to 29,842,1221,0,2063
2021-11-17,30 to 39,748,963,0,1711
2021-11-17,40 to 49,468,705,2,1175
2021-11-17,50 to 59,367,633,5,1005
2021-11-17,60 to 69,175,322,4,501
2021-11-17,70 to 79,57,123,8,188
2021-11-17,80 to 89,25,32,9,66
2021-11-17,90+,4,6,7,17
2021-11-17,Unknown,1,0,0,1
2021-11-17,Total,4051,5199,35,9285
2021-11-18,0 to 9,753,535,0,1288
2021-11-18,10 to 19,677,667,0,1344
2021-11-18,20 to 29,859,1226,0,2085
2021-11-18,30 to 39,771,971,0,1742
2021-11-18,40 to 49,482,708,2,1192
2021-11-18,50 to 59,381,633,5,1019
2021-11-18,60 to 69,180,324,4,508
2021-11-18,70 to 79,59,123,8,190
2021-11-18,80 to 89,25,32,9,66
2021-11-18,90+,4,6,7,17
2021-11-18,Unknown,1,0,0,1
2021-11-18,Total,4192,5225,35,9452
2021-11-20,0 to 9,820,549,0,1369
2021-11-20,10 to 19,707,694,0,1401
2021-11-20,20 to 29,915,1252,0,2167
2021-11-20,30 to 39,814,1000,0,1814
2021-11-20,40 to 49,498,728,3,1229
2021-11-20,50 to 59,392,648,5,1045
2021-11-20,60 to 69,179,330,5,514
2021-11-20,70 to 79,65,124,8,197
2021-11-20,80 to 89,25,32,10,67
2021-11-20,90+,3,6,8,17
2021-11-20,Unknown,3,0,0,3
2021-11-20,Total,4421,5363,39,9823
2021-11-21,0 to 9,825,576,0,1401
2021-11-21,10 to 19,718,715,0,1433
2021-11-21,20 to 29,918,1282,0,2200
2021-11-21,30 to 39,803,1037,0,1840
2021-11-21,40 to 49,496,737,3,1236
2021-11-21,50 to 59,395,656,5,1056
2021-11-21,60 to 69,185,331,5,521
2021-11-21,70 to 79,66,124,8,198
2021-11-21,80 to 89,25,32,10,67
2021-11-21,90+,3,6,8,17
2021-11-21,Unknown,3,0,0,3
2021-11-21,Total,4437,5496,39,9972
2021-11-22,0 to 9,877,577,0,1454
2021-11-22,10 to 19,750,715,0,1465
2021-11-22,20 to 29,955,1282,0,2237
2021-11-22,30 to 39,836,1037,0,1873
2021-11-22,40 to 49,515,738,4,1257
2021-11-22,50 to 59,411,656,5,1072
2021-11-22,60 to 69,196,331,5,532
2021-11-22,70 to 79,67,124,8,199
2021-11-22,80 to 89,26,32,10,68
2021-11-22,90+,3,6,8,17
2021-11-22,Unknown,2,0,0,2
2021-11-22,Total,4638,5498,40,10176
2021-11-23,0 to 9,941,583,0,1524
2021-11-23,10 to 19,784,718,0,1502
2021-11-23,20 to 29,1003,1288,0,2291
2021-11-23,30 to 39,858,1042,0,1900
2021-11-23,40 to 49,525,739,4,1268
2021-11-23,50 to 59,415,661,5,1081
2021-11-23,60 to 69,201,332,5,538
2021-11-23,70 to 79,69,124,8,201
2021-11-23,80 to 89,26,32,10,68
2021-11-23,90+,3,6,8,17
2021-11-23,Unknown,3,0,0,3
2021-11-23,Total,4828,5525,40,10393
2021-11-24,0 to 9,995,585,0,1580
2021-11-24,10 to 19,809,720,0,1529
2021-11-24,20 to 29,1053,1290,0,2343
2021-11-24,30 to 39,897,1043,0,1940
2021-11-24,40 to 49,544,739,4,1287
2021-11-24,50 to 59,429,661,5,1095
2021-11-24,60 to 69,207,332,5,544
2021-11-24,70 to 79,69,125,8,202
2021-11-24,80 to 89,27,32,10,69
2021-11-24,90+,3,6,8,17
2021-11-24,Unknown,3,0,0,3
2021-11-24,Total,5036,5533,40,10609
2021-11-25,0 to 9,1035,585,0,1620
2021-11-25,10 to 19,841,720,0,1561
2021-11-25,20 to 29,1091,1291,0,2382
2021-11-25,30 to 39,925,1043,0,1968
2021-11-25,40 to 49,565,739,4,1308
2021-11-25,50 to 59,440,662,6,1108
2021-11-25,60 to 69,214,332,5,551
2021-11-25,70 to 79,70,125,8,203
2021-11-25,80 to 89,27,32,10,69
2021-11-25,90+,3,6,8,17
2021-11-25,Unknown,2,0,0,2
2021-11-25,Total,5213,5535,41,10789
2021-11-26,0 to 9,1074,586,0,1660
2021-11-26,10 to 19,872,721,0,1593
2021-11-26,20 to 29,1131,1294,0,2425
2021-11-26,30 to 39,952,1046,0,1998
2021-11-26,40 to 49,577,741,4,1322
2021-11-26,50 to 59,447,664,7,1118
2021-11-26,60 to 69,218,333,5,556
2021-11-26,70 to 79,70,126,8,204
2021-11-26,80 to 89,28,32,10,70
2021-11-26,90+,4,6,8,18
2021-11-26,Unknown,2,0,0,2
2021-11-26,Total,5375,5549,42,10966
2021-11-27,0 to 9,1114,590,0,1704
2021-11-27,10 to 19,887,726,0,1613
2021-11-27,20 to 29,1161,1295,0,2456
2021-11-27,30 to 39,979,1048,0,2027
2021-11-27,40 to 49,584,745,4,1333
2021-11-27,50 to 59,451,665,7,1123
2021-11-27,60 to 69,224,334,5,563
2021-11-27,70 to 79,71,126,8,205
2021-11-27,80 to 89,28,32,10,70
2021-11-27,90+,4,6,8,18
2021-11-27,Unknown,2,0,0,2
2021-11-27,Total,5505,5567,42,11114
2021-11-28,0 to 9,1147,597,0,1744
2021-11-28,10 to 19,893,743,0,1636
2021-11-28,20 to 29,1180,1301,0,2481
2021-11-28,30 to 39,992,1058,0,2050
2021-11-28,40 to 49,587,757,4,1348
2021-11-28,50 to 59,451,677,7,1135
2021-11-28,60 to 69,225,336,5,566
2021-11-28,70 to 79,72,128,8,208
2021-11-28,80 to 89,27,32,11,70
2021-11-28,90+,4,6,8,18
2021-11-28,Unknown,4,0,0,4
2021-11-28,Total,5582,5635,43,11260
2021-11-29,0 to 9,1191,599,0,1790
2021-11-29,10 to 19,927,746,0,1673
2021-11-29,20 to 29,1210,1301,0,2511
2021-11-29,30 to 39,1018,1060,0,2078
2021-11-29,40 to 49,607,760,4,1371
2021-11-29,50 to 59,466,677,7,1150
2021-11-29,60 to 69,230,336,5,571
2021-11-29,70 to 79,74,128,8,210
2021-11-29,80 to 89,28,32,11,71
2021-11-29,90+,4,6,8,18
2021-11-29,Unknown,1,0,0,1
2021-11-29,Total,5756,5645,43,11444
2021-11-30,0 to 9,1226,600,0,1826
2021-11-30,10 to 19,946,749,0,1695
2021-11-30,20 to 29,1236,1302,0,2538
2021-11-30,30 to 39,1036,1062,0,2098
2021-11-30,40 to 49,619,760,4,1383
2021-11-30,50 to 59,475,677,7,1159
2021-11-30,60 to 69,232,337,5,574
2021-11-30,70 to 79,75,129,8,212
2021-11-30,80 to 89,27,32,12,71
2021-11-30,90+,4,6,8,18
2021-11-30,Unknown,2,0,0,2
2021-11-30,Total,5878,5654,44,11576
2021-12-01,0 to 9,1259,604,0,1863
2021-12-01,10 to 19,971,751,0,1722
2021-12-01,20 to 29,1261,1305,0,2566
2021-12-01,30 to 39,1059,1065,0,2124
2021-12-01,40 to 49,630,761,4,1395
2021-12-01,50 to 59,480,679,7,1166
2021-12-01,60 to 69,239,337,5,581
2021-12-01,70 to 79,75,131,8,214
2021-12-01,80 to 89,28,32,12,72
2021-12-01,90+,4,6,8,18
2021-12-01,Unknown,2,0,0,2
2021-12-01,Total,6008,5671,44,11723
2021-12-02,0 to 9,1285,612,0,1897
2021-12-02,10 to 19,1002,764,0,1766
2021-12-02,20 to 29,1295,1310,0,2605
2021-12-02,30 to 39,1081,1068,0,2149
2021-12-02,40 to 49,642,762,4,1408
2021-12-02,50 to 59,488,680,7,1175
2021-12-02,60 to 69,240,339,5,584
2021-12-02,70 to 79,80,131,8,219
2021-12-02,80 to 89,28,32,12,72
2021-12-02,90+,4,6,8,18
2021-12-02,Unknown,2,0,0,2
2021-12-02,Total,6147,5704,44,11895
2021-12-03,0 to 9,1284,622,0,1906
2021-12-03,10 to 19,1001,783,0,1784
2021-12-03,20 to 29,1314,1315,0,2629
2021-12-03,30 to 39,1093,1078,0,2171
2021-12-03,40 to 49,646,769,4,1419
2021-12-03,50 to 59,491,683,7,1181
2021-12-03,60 to 69,246,340,5,591
2021-12-03,70 to 79,80,131,8,219
2021-12-03,80 to 89,28,32,12,72
2021-12-03,90+,4,6,8,18
2021-12-03,Unknown,2,0,0,2
2021-12-03,Total,6189,5759,44,11992
2021-12-04,0 to 9,1301,624,0,1925
2021-12-04,10 to 19,1016,784,0,1800
2021-12-04,20 to 29,1336,1320,0,2656
2021-12-04,30 to 39,1098,1081,0,2179
2021-12-04,40 to 49,653,770,4,1427
2021-12-04,50 to 59,500,684,7,1191
2021-12-04,60 to 69,249,340,5,594
2021-12-04,70 to 79,82,132,8,222
2021-12-04,80 to 89,29,32,12,73
2021-12-04,90+,4,6,8,18
2021-12-04,Unknown,2,0,0,2
2021-12-04,Total,6270,5773,44,12087
2021-12-05,0 to 9,1316,630,0,1946
2021-12-05,10 to 19,1029,795,0,1824
2021-12-05,20 to 29,1339,1340,0,2679
2021-12-05,30 to 39,1105,1094,0,2199
2021-12-05,40 to 49,655,777,4,1436
2021-12-05,50 to 59,502,687,7,1196
2021-12-05,60 to 69,251,341,5,597
2021-12-05,70 to 79,85,132,8,225
2021-12-05,80 to 89,29,32,12,73
2021-12-05,90+,4,6,8,18
2021-12-05,Unknown,2,0,0,2
2021-12-05,Total,6317,5834,44,12195
2021-12-06,0 to 9,1334,639,0,1973
2021-12-06,10 to 19,1040,805,0,1845
2021-12-06,20 to 29,1358,1351,0,2709
2021-12-06,30 to 39,1129,1100,0,2229
2021-12-06,40 to 49,658,786,4,1448
2021-12-06,50 to 59,509,689,7,1205
2021-12-06,60 to 69,254,343,5,602
2021-12-06,70 to 79,85,134,8,227
2021-12-06,80 to 89,29,32,12,73
2021-12-06,90+,4,6,8,18
2021-12-06,Unknown,2,0,0,2
2021-12-06,Total,6402,5885,44,12331
2021-12-07,0 to 9,1350,655,0,2005
2021-12-07,10 to 19,1048,815,0,1863
2021-12-07,20 to 29,1363,1360,0,2723
2021-12-07,30 to 39,1120,1122,0,2242
2021-12-07,40 to 49,658,798,4,1460
2021-12-07,50 to 59,509,696,7,1212
2021-12-07,60 to 69,250,348,5,603
2021-12-07,70 to 79,84,135,8,227
2021-12-07,80 to 89,29,32,12,73
2021-12-07,90+,4,6,8,18
2021-12-07,Unknown,1,1,0,2
2021-12-07,Total,6416,5968,44,12428
2021-12-08,0 to 9,1358,663,0,2021
2021-12-08,10 to 19,1056,820,0,1876
2021-12-08,20 to 29,1376,1369,0,2745
2021-12-08,30 to 39,1124,1133,0,2257
2021-12-08,40 to 49,662,802,4,1468
2021-12-08,50 to 59,516,698,7,1221
2021-12-08,60 to 69,251,350,5,606
2021-12-08,70 to 79,85,135,8,228
2021-12-08,80 to 89,30,32,12,74
2021-12-08,90+,4,6,8,18
2021-12-08,Unknown,1,1,0,2
2021-12-08,Total,6463,6009,44,12516
2021-12-09,0 to 9,1374,663,0,2037
2021-12-09,10 to 19,1066,825,0,1891
2021-12-09,20 to 29,1392,1371,0,2763
2021-12-09,30 to 39,1147,1133,0,2280
2021-12-09,40 to 49,674,803,4,1481
2021-12-09,50 to 59,523,700,7,1230
2021-12-09,60 to 69,259,350,5,614
2021-12-09,70 to 79,87,135,8,230
2021-12-09,80 to 89,31,32,12,75
2021-12-09,90+,4,6,8,18
2021-12-09,Unknown,1,1,0,2
2021-12-09,Total,6558,6019,44,12621
2021-12-10,0 to 9,1390,665,0,2055
2021-12-10,10 to 19,1076,828,0,1904
2021-12-10,20 to 29,1406,1380,0,2786
2021-12-10,30 to 39,1161,1137,0,2298
2021-12-10,40 to 49,681,804,4,1489
2021-12-10,50 to 59,528,703,7,1238
2021-12-10,60 to 69,259,352,5,616
2021-12-10,70 to 79,92,135,8,235
2021-12-10,80 to 89,32,32,12,76
2021-12-10,90+,4,6,8,18
2021-12-10,Unknown,1,1,0,2
2021-12-10,Total,6630,6043,44,12717
2021-12-11,0 to 9,1402,669,0,2071
2021-12-11,10 to 19,1075,836,0,1911
2021-12-11,20 to 29,1414,1387,0,2801
2021-12-11,30 to 39,1165,1143,1,2309
2021-12-11,40 to 49,682,807,4,1493
2021-12-11,50 to 59,532,706,7,1245
2021-12-11,60 to 69,262,352,5,619
2021-12-11,70 to 79,91,135,9,235
2021-12-11,80 to 89,33,32,12,77
2021-12-11,90+,4,6,8,18
2021-12-11,Unknown,1,1,0,2
2021-12-11,Total,6661,6074,46,12781
2021-12-12,0 to 9,1423,673,0,2096
2021-12-12,10 to 19,1093,838,0,1931
2021-12-12,20 to 29,1418,1393,0,2811
2021-12-12,30 to 39,1181,1152,1,2334
2021-12-12,40 to 49,689,809,4,1502
2021-12-12,50 to 59,538,708,7,1253
2021-12-12,60 to 69,265,352,5,622
2021-12-12,70 to 79,93,135,9,237
2021-12-12,80 to 89,34,32,12,78
2021-12-12,90+,4,6,8,18
2021-12-12,Unknown,0,2,0,2
2021-12-12,Total,6738,6100,46,12884
2021-12-13,0 to 9,1451,675,0,2126
2021-12-13,10 to 19,1106,842,0,1948
2021-12-13,20 to 29,1433,1398,0,2831
2021-12-13,30 to 39,1193,1157,1,2351
2021-12-13,40 to 49,687,816,4,1507
2021-12-13,50 to 59,542,711,7,1260
2021-12-13,60 to 69,267,354,6,627
2021-12-13,70 to 79,93,135,9,237
2021-12-13,80 to 89,35,32,12,79
2021-12-13,90+,4,6,8,18
2021-12-13,Unknown,0,2,0,2
2021-12-13,Total,6811,6128,47,12986
2021-12-14,0 to 9,1467,682,0,2149
2021-12-14,10 to 19,1118,844,0,1962
2021-12-14,20 to 29,1440,1404,0,2844
2021-12-14,30 to 39,1204,1160,1,2365
2021-12-14,40 to 49,693,818,4,1515
2021-12-14,50 to 59,539,718,7,1264
2021-12-14,60 to 69,269,356,6,631
2021-12-14,70 to 79,93,135,9,237
2021-12-14,80 to 89,35,32,12,79
2021-12-14,90+,4,6,8,18
2021-12-14,Unknown,1,2,0,3
2021-12-14,Total,6863,6157,47,13067
2021-12-15,0 to 9,1480,683,0,2163
2021-12-15,10 to 19,1127,850,0,1977
2021-12-15,20 to 29,1449,1413,0,2862
2021-12-15,30 to 39,1205,1168,1,2374
2021-12-15,40 to 49,698,824,4,1526
2021-12-15,50 to 59,540,724,7,1271
2021-12-15,60 to 69,269,356,6,631
2021-12-15,70 to 79,94,135,9,238
2021-12-15,80 to 89,37,32,12,81
2021-12-15,90+,4,6,8,18
2021-12-15,Unknown,0,2,0,2
2021-12-15,Total,6903,6193,47,13143
2021-12-16,0 to 9,533,1649,0,2182
2021-12-16,10 to 19,396,1597,0,1993
2021-12-16,20 to 29,443,2434,0,2877
2021-12-16,30 to 39,372,2014,1,2387
2021-12-16,40 to 49,195,1335,4,1534
2021-12-16,50 to 59,149,1122,7,1278
2021-12-16,60 to 69,77,553,7,637
2021-12-16,70 to 79,32,197,9,238
2021-12-16,80 to 89,11,58,12,81
2021-12-16,90+,1,9,8,18
2021-12-16,Unknown,10,3,0,13
2021-12-16,Total,2219,10971,48,13238
2021-12-17,0 to 9,505,1695,1,2201
2021-12-17,10 to 19,377,1632,0,2009
2021-12-17,20 to 29,426,2476,0,2902
2021-12-17,30 to 39,347,2053,1,2401
2021-12-17,40 to 49,185,1351,4,1540
2021-12-17,50 to 59,143,1132,7,1282
2021-12-17,60 to 69,74,558,7,639
2021-12-17,70 to 79,31,199,9,239
2021-12-17,80 to 89,11,58,12,81
2021-12-17,90+,0,10,8,18
2021-12-17,Unknown,3,2,0,5
2021-12-17,Total,2102,11166,49,13317
2021-12-18,0 to 9,469,1737,1,2207
2021-12-18,10 to 19,363,1657,0,2020
2021-12-18,20 to 29,402,2511,0,2913
2021-12-18,30 to 39,324,2082,1,2407
2021-12-18,40 to 49,178,1363,4,1545
2021-12-18,50 to 59,143,1138,7,1288
2021-12-18,60 to 69,70,565,7,642
2021-12-18,70 to 79,30,201,9,240
2021-12-18,80 to 89,11,58,12,81
2021-12-18,90+,0,10,8,18
2021-12-18,Unknown,3,2,0,5
2021-12-18,Total,1993,11324,49,13366
2021-12-18,0 to 9,437,1777,1,2215
2021-12-18,10 to 19,351,1676,0,2027
2021-12-18,20 to 29,384,2540,0,2924
2021-12-18,30 to 39,308,2109,1,2418
2021-12-18,40 to 49,172,1380,4,1556
2021-12-18,50 to 59,138,1151,7,1296
2021-12-18,60 to 69,69,568,7,644
2021-12-18,70 to 79,28,203,9,240
2021-12-18,80 to 89,12,58,12,82
2021-12-18,90+,0,10,8,18
2021-12-18,Unknown,3,2,0,5
2021-12-18,Total,1902,11474,49,13425
2021-12-19,0 to 9,437,1777,1,2215
2021-12-19,10 to 19,351,1676,0,2027
2021-12-19,20 to 29,384,2540,0,2924
2021-12-19,30 to 39,308,2109,1,2418
2021-12-19,40 to 49,172,1380,4,1556
2021-12-19,50 to 59,138,1151,7,1296
2021-12-19,60 to 69,69,568,7,644
2021-12-19,70 to 79,28,203,9,240
2021-12-19,80 to 89,12,58,12,82
2021-12-19,90+,0,10,8,18
2021-12-19,Unknown,3,2,0,5
2021-12-19,Total,1902,11474,49,13425
2021-12-19,0 to 9,402,1827,1,2230
2021-12-19,10 to 19,327,1710,0,2037
2021-12-19,20 to 29,374,2563,0,2937
2021-12-19,30 to 39,291,2134,1,2426
2021-12-19,40 to 49,168,1395,4,1567
2021-12-19,50 to 59,134,1162,7,1303
2021-12-19,60 to 69,67,573,7,647
2021-12-19,70 to 79,26,207,9,242
2021-12-19,80 to 89,12,59,12,83
2021-12-19,90+,0,10,8,18
2021-12-19,Unknown,3,2,0,5
2021-12-19,Total,1804,11642,49,13495
2021-12-20,0 to 9,379,1858,1,2238
2021-12-20,10 to 19,315,1734,0,2049
2021-12-20,20 to 29,356,2587,0,2943
2021-12-20,30 to 39,279,2150,1,2430
2021-12-20,40 to 49,159,1408,4,1571
2021-12-20,50 to 59,131,1167,7,1305
2021-12-20,60 to 69,63,579,7,649
2021-12-20,70 to 79,26,207,9,242
2021-12-20,80 to 89,12,59,12,83
2021-12-20,90+,0,10,8,18
2021-12-20,Unknown,1,2,0,3
2021-12-20,Total,1721,11761,49,13531
2021-12-21,0 to 9,354,1895,1,2250
2021-12-21,10 to 19,299,1756,0,2055
2021-12-21,20 to 29,345,2614,0,2959
2021-12-21,30 to 39,267,2169,1,2437
2021-12-21,40 to 49,157,1416,4,1577
2021-12-21,50 to 59,131,1174,7,1312
2021-12-21,60 to 69,62,582,7,651
2021-12-21,70 to 79,26,209,9,244
2021-12-21,80 to 89,11,60,12,83
2021-12-21,90+,0,10,8,18
2021-12-21,Unknown,1,2,0,3
2021-12-21,Total,1653,11887,49,13589
2021-12-22,0 to 9,345,1919,1,2265
2021-12-22,10 to 19,275,1788,0,2063
2021-12-22,20 to 29,330,2642,0,2972
2021-12-22,30 to 39,263,2186,1,2450
2021-12-22,40 to 49,151,1424,4,1579
2021-12-22,50 to 59,128,1181,7,1316
2021-12-22,60 to 69,60,588,7,655
2021-12-22,70 to 79,23,213,9,245
2021-12-22,80 to 89,10,61,12,83
2021-12-22,90+,0,10,8,18
2021-12-22,Unknown,0,2,0,2
2021-12-22,Total,1585,12014,49,13648
2021-12-23,0 to 9,347,1934,1,2282
2021-12-23,10 to 19,261,1809,0,2070
2021-12-23,20 to 29,323,2664,0,2987
2021-12-23,30 to 39,255,2208,1,2464
2021-12-23,40 to 49,149,1436,4,1589
2021-12-23,50 to 59,127,1189,7,1323
2021-12-23,60 to 69,53,595,7,655
2021-12-23,70 to 79,22,214,9,245
2021-12-23,80 to 89,10,61,12,83
2021-12-23,90+,0,10,8,18
2021-12-23,Unknown,1,2,0,3
2021-12-23,Total,1548,12122,49,13719
2021-12-25,0 to 9,331,1986,1,2318
2021-12-25,10 to 19,242,1852,0,2094
2021-12-25,20 to 29,284,2723,0,3007
2021-12-25,30 to 39,233,2245,1,2479
2021-12-25,40 to 49,142,1454,4,1600
2021-12-25,50 to 59,125,1206,8,1339
2021-12-25,60 to 69,54,603,7,664
2021-12-25,70 to 79,23,218,9,250
2021-12-25,80 to 89,9,62,12,83
2021-12-25,90+,0,10,8,18
2021-12-25,Unknown,1,2,0,3
2021-12-25,Total,1444,12361,50,13855
2021-12-26,0 to 9,311,2011,1,2323
2021-12-26,10 to 19,223,1876,0,2099
2021-12-26,20 to 29,272,2743,0,3015
2021-12-26,30 to 39,228,2259,1,2488
2021-12-26,40 to 49,141,1462,4,1607
2021-12-26,50 to 59,130,1208,8,1346
2021-12-26,60 to 69,55,605,7,667
2021-12-26,70 to 79,21,220,9,250
2021-12-26,80 to 89,9,62,12,83
2021-12-26,90+,0,10,8,18
2021-12-26,Unknown,1,2,0,3
2021-12-26,Total,1391,12458,50,13899
2021-12-27,0 to 9,293,2032,1,2326
2021-12-27,10 to 19,208,1896,0,2104
2021-12-27,20 to 29,260,2760,0,3020
2021-12-27,30 to 39,222,2274,1,2497
2021-12-27,40 to 49,139,1469,4,1612
2021-12-27,50 to 59,127,1213,8,1348
2021-12-27,60 to 69,54,609,7,670
2021-12-27,70 to 79,21,220,9,250
2021-12-27,80 to 89,9,63,12,84
2021-12-27,90+,0,10,8,18
2021-12-27,Unknown,1,2,0,3
2021-12-27,Total,1334,12548,50,13932
2021-12-28,0 to 9,291,2052,1,2344
2021-12-28,10 to 19,191,1918,0,2109
2021-12-28,20 to 29,249,2783,0,3032
2021-12-28,30 to 39,218,2290,1,2509
2021-12-28,40 to 49,124,1486,4,1614
2021-12-28,50 to 59,117,1225,8,1350
2021-12-28,60 to 69,54,612,7,673
2021-12-28,70 to 79,19,221,10,250
2021-12-28,80 to 89,8,64,12,84
2021-12-28,90+,0,10,8,18
2021-12-28,Unknown,1,2,0,3
2021-12-28,Total,1272,12663,51,13986
2021-12-29,0 to 9,296,2070,1,2367
2021-12-29,10 to 19,177,1942,0,2119
2021-12-29,20 to 29,238,2803,0,3041
2021-12-29,30 to 39,202,2313,1,2516
2021-12-29,40 to 49,118,1500,4,1622
2021-12-29,50 to 59,112,1233,8,1353
2021-12-29,60 to 69,51,619,7,677
2021-12-29,70 to 79,22,223,10,255
2021-12-29,80 to 89,8,65,12,85
2021-12-29,90+,0,10,8,18
2021-12-29,Unknown,2,2,0,4
2021-12-29,Total,1226,12780,51,14057
2021-12-30,0 to 9,288,2086,1,2375
2021-12-30,10 to 19,177,1954,0,2131
2021-12-30,20 to 29,226,2826,0,3052
2021-12-30,30 to 39,196,2328,1,2525
2021-12-30,40 to 49,120,1506,4,1630
2021-12-30,50 to 59,108,1243,8,1359
2021-12-30,60 to 69,51,621,7,679
2021-12-30,70 to 79,22,228,10,260
2021-12-30,80 to 89,7,66,12,85
2021-12-30,90+,0,10,8,18
2021-12-30,Unknown,2,2,0,4
2021-12-30,Total,1197,12870,51,14118
2022-01-01,0 to 9,283,2129,1,2413
2022-01-01,10 to 19,163,1986,0,2149
2022-01-01,20 to 29,217,2854,0,3071
2022-01-01,30 to 39,185,2361,1,2547
2022-01-01,40 to 49,118,1519,4,1641
2022-01-01,50 to 59,105,1261,8,1374
2022-01-01,60 to 69,53,626,7,686
2022-01-01,70 to 79,25,229,10,264
2022-01-01,80 to 89,8,67,12,87
2022-01-01,90+,2,10,8,20
2022-01-01,Unknown,1,2,0,3
2022-01-01,Total,1160,13044,51,14255
2022-01-02,0 to 9,270,2149,1,2420
2022-01-02,10 to 19,155,1998,0,2153
2022-01-02,20 to 29,216,2863,0,3079
2022-01-02,30 to 39,182,2374,1,2557
2022-01-02,40 to 49,122,1524,4,1650
2022-01-02,50 to 59,103,1271,8,1382
2022-01-02,60 to 69,52,628,7,687
2022-01-02,70 to 79,25,230,10,265
2022-01-02,80 to 89,10,68,12,90
2022-01-02,90+,2,10,8,20
2022-01-02,Unknown,1,2,0,3
2022-01-02,Total,1138,13117,51,14306
2022-01-03,0 to 9,264,2165,1,2430
2022-01-03,10 to 19,156,2004,0,2160
2022-01-03,20 to 29,215,2871,0,3086
2022-01-03,30 to 39,184,2387,1,2572
2022-01-03,40 to 49,127,1528,4,1659
2022-01-03,50 to 59,109,1274,8,1391
2022-01-03,60 to 69,50,632,7,689
2022-01-03,70 to 79,25,230,10,265
2022-01-03,80 to 89,10,68,12,90
2022-01-03,90+,2,10,8,20
2022-01-03,Unknown,1,2,0,3
2022-01-03,Total,1143,13171,51,14365
2022-01-04,0 to 9,258,2178,1,2437
2022-01-04,10 to 19,147,2019,0,2166
2022-01-04,20 to 29,203,2888,0,3091
2022-01-04,30 to 39,182,2399,1,2582
2022-01-04,40 to 49,124,1537,4,1665
2022-01-04,50 to 59,102,1283,8,1393
2022-01-04,60 to 69,51,634,7,692
2022-01-04,70 to 79,22,234,10,266
2022-01-04,80 to 89,10,68,12,90
2022-01-04,90+,2,10,8,20
2022-01-04,Unknown,1,2,0,3
2022-01-04,Total,1102,13252,51,14405
2022-01-05,0 to 9,237,2203,1,2441
2022-01-05,10 to 19,140,2030,0,2170
2022-01-05,20 to 29,205,2901,0,3106
2022-01-05,30 to 39,194,2412,1,2607
2022-01-05,40 to 49,120,1545,4,1669
2022-01-05,50 to 59,103,1290,8,1401
2022-01-05,60 to 69,48,639,7,694
2022-01-05,70 to 79,22,234,10,266
2022-01-05,80 to 89,9,69,12,90
2022-01-05,90+,2,10,8,20
2022-01-05,Unknown,1,2,0,3
2022-01-05,Total,1081,13335,51,14467
2022-01-06,0 to 9,227,2224,1,2452
2022-01-06,10 to 19,143,2036,0,2179
2022-01-06,20 to 29,196,2923,0,3119
2022-01-06,30 to 39,194,2422,1,2617
2022-01-06,40 to 49,119,1549,4,1672
2022-01-06,50 to 59,107,1294,8,1409
2022-01-06,60 to 69,48,641,7,696
2022-01-06,70 to 79,23,235,10,268
2022-01-06,80 to 89,8,70,12,90
2022-01-06,90+,2,10,8,20
2022-01-06,Unknown,1,2,0,3
2022-01-06,Total,1068,13406,51,14525
2022-01-08,0 to 9,229,2246,1,2476
2022-01-08,10 to 19,140,2052,0,2192
2022-01-08,20 to 29,204,2951,0,3155
2022-01-08,30 to 39,206,2441,1,2648
2022-01-08,40 to 49,121,1566,4,1691
2022-01-08,50 to 59,99,1314,8,1421
2022-01-08,60 to 69,55,645,7,707
2022-01-08,70 to 79,21,237,10,268
2022-01-08,80 to 89,8,71,12,91
2022-01-08,90+,2,10,8,20
2022-01-08,Unknown,2,2,0,4
2022-01-08,Total,1087,13535,51,14673
2022-01-09,0 to 9,221,2262,1,2484
2022-01-09,10 to 19,138,2060,0,2198
2022-01-09,20 to 29,199,2969,0,3168
2022-01-09,30 to 39,214,2450,1,2665
2022-01-09,40 to 49,117,1576,4,1697
2022-01-09,50 to 59,96,1321,8,1425
2022-01-09,60 to 69,57,649,7,713
2022-01-09,70 to 79,19,239,10,268
2022-01-09,80 to 89,8,71,12,91
2022-01-09,90+,2,10,8,20
2022-01-09,Unknown,2,2,0,4
2022-01-09,Total,1073,13609,51,14733
2022-01-10,0 to 9,213,2272,1,2486
2022-01-10,10 to 19,132,2069,0,2201
2022-01-10,20 to 29,199,2974,0,3173
2022-01-10,30 to 39,214,2456,1,2671
2022-01-10,40 to 49,114,1581,4,1699
2022-01-10,50 to 59,95,1323,8,1426
2022-01-10,60 to 69,54,653,7,714
2022-01-10,70 to 79,16,243,10,269
2022-01-10,80 to 89,10,71,12,93
2022-01-10,90+,2,10,8,20
2022-01-10,Unknown,2,2,0,4
2022-01-10,Total,1051,13654,51,14756
2022-01-11,0 to 9,208,2295,1,2504
2022-01-11,10 to 19,138,2076,0,2214
2022-01-11,20 to 29,191,2996,0,3187
2022-01-11,30 to 39,229,2464,2,2695
2022-01-11,40 to 49,119,1588,4,1711
2022-01-11,50 to 59,92,1331,8,1431
2022-01-11,60 to 69,56,655,7,718
2022-01-11,70 to 79,15,245,10,270
2022-01-11,80 to 89,9,72,12,93
2022-01-11,90+,3,10,8,21
2022-01-11,Unknown,2,2,0,4
2022-01-11,Total,1062,13734,52,14848
2022-01-12,0 to 9,196,2311,1,2508
2022-01-12,10 to 19,138,2081,0,2219
2022-01-12,20 to 29,185,3009,0,3194
2022-01-12,30 to 39,221,2482,2,2705
2022-01-12,40 to 49,114,1597,4,1715
2022-01-12,50 to 59,92,1335,8,1435
2022-01-12,60 to 69,58,656,7,721
2022-01-12,70 to 79,16,245,10,271
2022-01-12,80 to 89,9,72,12,93
2022-01-12,90+,3,10,8,21
2022-01-12,Unknown,3,2,0,5
2022-01-12,Total,1035,13800,52,14887
2022-01-13,0 to 9,194,2322,1,2517
2022-01-13,10 to 19,135,2090,0,2225
2022-01-13,20 to 29,188,3016,0,3204
2022-01-13,30 to 39,228,2490,2,2720
2022-01-13,40 to 49,119,1602,4,1725
2022-01-13,50 to 59,92,1338,8,1438
2022-01-13,60 to 69,65,657,7,729
2022-01-13,70 to 79,16,245,10,271
2022-01-13,80 to 89,9,72,12,93
2022-01-13,90+,3,10,8,21
2022-01-13,Unknown,2,2,0,4
2022-01-13,Total,1051,13844,52,14947
2022-01-14,0 to 9,175,2345,1,2521
2022-01-14,10 to 19,133,2106,0,2239
2022-01-14,20 to 29,185,3032,0,3217
2022-01-14,30 to 39,226,2501,2,2729
2022-01-14,40 to 49,111,1614,4,1729
2022-01-14,50 to 59,85,1350,8,1443
2022-01-14,60 to 69,62,664,7,733
2022-01-14,70 to 79,15,247,10,272
2022-01-14,80 to 89,8,73,12,93
2022-01-14,90+,3,10,8,21
2022-01-14,Unknown,2,2,0,4
2022-01-14,Total,1005,13944,52,15001
2022-01-15,0 to 9,177,2357,1,2535
2022-01-15,10 to 19,136,2111,0,2247
2022-01-15,20 to 29,187,3038,0,3225
2022-01-15,30 to 39,238,2506,2,2746
2022-01-15,40 to 49,119,1618,4,1741
2022-01-15,50 to 59,82,1358,8,1448
2022-01-15,60 to 69,59,671,7,737
2022-01-15,70 to 79,14,248,10,272
2022-01-15,80 to 89,8,73,12,93
2022-01-15,90+,3,10,8,21
2022-01-15,Unknown,2,2,0,4
2022-01-15,Total,1025,13992,52,15069
2022-01-16,0 to 9,177,2364,1,2542
2022-01-16,10 to 19,136,2117,0,2253
2022-01-16,20 to 29,191,3050,0,3241
2022-01-16,30 to 39,230,2530,2,2762
2022-01-16,40 to 49,120,1623,4,1747
2022-01-16,50 to 59,84,1362,8,1454
2022-01-16,60 to 69,59,672,7,738
2022-01-16,70 to 79,14,248,10,272
2022-01-16,80 to 89,8,73,12,93
2022-01-16,90+,3,10,8,21
2022-01-16,Unknown,2,2,0,4
2022-01-16,Total,1024,14051,52,15127
2022-01-17,0 to 9,181,2374,1,2556
2022-01-17,10 to 19,131,2125,0,2256
2022-01-17,20 to 29,191,3056,0,3247
2022-01-17,30 to 39,237,2535,2,2774
2022-01-17,40 to 49,119,1626,4,1749
2022-01-17,50 to 59,82,1366,8,1456
2022-01-17,60 to 69,60,674,7,741
2022-01-17,70 to 79,15,248,10,273
2022-01-17,80 to 89,7,74,12,93
2022-01-17,90+,3,10,8,21
2022-01-17,Unknown,2,2,0,4
2022-01-17,Total,1028,14090,52,15170
2022-01-18,0 to 9,175,2393,1,2569
2022-01-18,10 to 19,132,2135,0,2267
2022-01-18,20 to 29,195,3067,0,3262
2022-01-18,30 to 39,229,2560,2,2791
2022-01-18,40 to 49,126,1632,4,1762
2022-01-18,50 to 59,83,1371,8,1462
2022-01-18,60 to 69,58,678,7,743
2022-01-18,70 to 79,17,249,10,276
2022-01-18,80 to 89,7,74,12,93
2022-01-18,90+,3,10,8,21
2022-01-18,Unknown,1,2,0,3
2022-01-18,Total,1026,14171,52,15249
2022-01-19,0 to 9,178,2402,1,2581
2022-01-19,10 to 19,133,2145,0,2278
2022-01-19,20 to 29,196,3083,0,3279
2022-01-19,30 to 39,227,2576,2,2805
2022-01-19,40 to 49,136,1640,4,1780
2022-01-19,50 to 59,80,1379,8,1467
2022-01-19,60 to 69,58,684,7,749
2022-01-19,70 to 79,17,250,10,277
2022-01-19,80 to 89,7,74,12,93
2022-01-19,90+,3,10,8,21
2022-01-19,Unknown,2,2,0,4
2022-01-19,Total,1037,14245,52,15334
2022-01-20,0 to 9,181,2412,1,2594
2022-01-20,10 to 19,131,2155,0,2286
2022-01-20,20 to 29,195,3094,0,3289
2022-01-20,30 to 39,237,2585,2,2824
2022-01-20,40 to 49,135,1650,4,1789
2022-01-20,50 to 59,82,1382,8,1472
2022-01-20,60 to 69,59,685,7,751
2022-01-20,70 to 79,16,251,10,277
2022-01-20,80 to 89,7,74,12,93
2022-01-20,90+,3,10,8,21
2022-01-20,Unknown,3,2,0,5
2022-01-20,Total,1049,14300,52,15401
2022-01-21,0 to 9,182,2421,1,2604
2022-01-21,10 to 19,141,2161,0,2302
2022-01-21,20 to 29,195,3101,0,3296
2022-01-21,30 to 39,243,2598,2,2843
2022-01-21,40 to 49,139,1654,4,1797
2022-01-21,50 to 59,83,1392,8,1483
2022-01-21,60 to 69,61,688,7,756
2022-01-21,70 to 79,15,254,10,279
2022-01-21,80 to 89,6,76,12,94
2022-01-21,90+,1,12,8,21
2022-01-21,Unknown,2,2,0,4
2022-01-21,Total,1068,14359,52,15479
2022-01-22,0 to 9,181,2439,1,2621
2022-01-22,10 to 19,142,2165,0,2307
2022-01-22,20 to 29,204,3107,0,3311
2022-01-22,30 to 39,250,2604,2,2856
2022-01-22,40 to 49,139,1659,4,1802
2022-01-22,50 to 59,88,1395,8,1491
2022-01-22,60 to 69,67,688,7,762
2022-01-22,70 to 79,16,255,10,281
2022-01-22,80 to 89,6,76,12,94
2022-01-22,90+,1,12,8,21
2022-01-22,Unknown,2,2,0,4
2022-01-22,Total,1096,14402,52,15550
2022-01-23,0 to 9,189,2444,1,2634
2022-01-23,10 to 19,145,2170,0,2315
2022-01-23,20 to 29,215,3111,0,3326
2022-01-23,30 to 39,266,2609,2,2877
2022-01-23,40 to 49,142,1667,4,1813
2022-01-23,50 to 59,85,1403,8,1496
2022-01-23,60 to 69,68,688,7,763
2022-01-23,70 to 79,16,256,10,282
2022-01-23,80 to 89,4,78,12,94
2022-01-23,90+,1,12,8,21
2022-01-23,Unknown,2,2,0,4
2022-01-23,Total,1133,14440,52,15625
2022-01-24,0 to 9,189,2451,1,2641
2022-01-24,10 to 19,143,2176,0,2319
2022-01-24,20 to 29,226,3115,0,3341
2022-01-24,30 to 39,278,2613,2,2893
2022-01-24,40 to 49,145,1673,4,1822
2022-01-24,50 to 59,90,1406,8,1504
2022-01-24,60 to 69,69,689,7,765
2022-01-24,70 to 79,16,256,10,282
2022-01-24,80 to 89,4,78,12,94
2022-01-24,90+,1,12,8,21
2022-01-24,Unknown,3,2,0,5
2022-01-24,Total,1164,14471,52,15687
2022-01-25,0 to 9,189,2456,1,2646
2022-01-25,10 to 19,145,2180,0,2325
2022-01-25,20 to 29,232,3123,0,3355
2022-01-25,30 to 39,279,2621,2,2902
2022-01-25,40 to 49,150,1677,4,1831
2022-01-25,50 to 59,101,1407,8,1516
2022-01-25,60 to 69,70,691,7,768
2022-01-25,70 to 79,17,256,10,283
2022-01-25,80 to 89,4,78,12,94
2022-01-25,90+,1,12,8,21
2022-01-25,Unknown,2,2,0,4
2022-01-25,Total,1190,14503,52,15745
2022-01-26,0 to 9,199,2462,1,2662
2022-01-26,10 to 19,155,2184,0,2339
2022-01-26,20 to 29,230,3136,0,3366
2022-01-26,30 to 39,292,2631,2,2925
2022-01-26,40 to 49,154,1684,4,1842
2022-01-26,50 to 59,108,1412,8,1528
2022-01-26,60 to 69,76,692,7,775
2022-01-26,70 to 79,20,256,10,286
2022-01-26,80 to 89,4,78,12,94
2022-01-26,90+,1,12,8,21
2022-01-26,Unknown,2,2,0,4
2022-01-26,Total,1241,14549,52,15842
2022-01-27,0 to 9,208,2473,1,2682
2022-01-27,10 to 19,175,2193,0,2368
2022-01-27,20 to 29,233,3156,0,3389
2022-01-27,30 to 39,315,2642,2,2959
2022-01-27,40 to 49,163,1691,4,1858
2022-01-27,50 to 59,116,1419,8,1543
2022-01-27,60 to 69,82,695,7,784
2022-01-27,70 to 79,21,258,10,289
2022-01-27,80 to 89,4,78,12,94
2022-01-27,90+,1,12,8,21
2022-01-27,Unknown,2,2,0,4
2022-01-27,Total,1320,14619,52,15991
2022-01-28,0 to 9,216,2484,1,2701
2022-01-28,10 to 19,196,2196,0,2392
2022-01-28,20 to 29,244,3175,0,3419
2022-01-28,30 to 39,332,2657,2,2991
2022-01-28,40 to 49,171,1702,4,1877
2022-01-28,50 to 59,127,1424,8,1559
2022-01-28,60 to 69,89,700,7,796
2022-01-28,70 to 79,22,258,10,290
2022-01-28,80 to 89,4,78,12,94
2022-01-28,90+,1,12,8,21
2022-01-28,Unknown,3,3,0,6
2022-01-28,Total,1405,14689,52,16146
2022-01-29,0 to 9,230,2491,1,2722
2022-01-29,10 to 19,211,2203,0,2414
2022-01-29,20 to 29,258,3185,0,3443
2022-01-29,30 to 39,349,2668,2,3019
2022-01-29,40 to 49,182,1708,4,1894
2022-01-29,50 to 59,140,1426,8,1574
2022-01-29,60 to 69,91,704,7,802
2022-01-29,70 to 79,27,258,10,295
2022-01-29,80 to 89,3,79,12,94
2022-01-29,90+,1,12,8,21
2022-01-29,Unknown,5,3,0,8
2022-01-29,Total,1497,14737,52,16286
2022-01-30,0 to 9,237,2499,1,2737
2022-01-30,10 to 19,224,2211,0,2435
2022-01-30,20 to 29,270,3198,0,3468
2022-01-30,30 to 39,357,2686,2,3045
2022-01-30,40 to 49,191,1718,4,1913
2022-01-30,50 to 59,146,1433,8,1587
2022-01-30,60 to 69,87,712,7,806
2022-01-30,70 to 79,29,258,11,298
2022-01-30,80 to 89,5,80,12,97
2022-01-30,90+,1,12,8,21
2022-01-30,Unknown,6,3,0,9
2022-01-30,Total,1553,14810,53,16416
2022-01-31,0 to 9,257,2508,1,2766
2022-01-31,10 to 19,258,2221,0,2479
2022-01-31,20 to 29,299,3203,0,3502
2022-01-31,30 to 39,384,2701,2,3087
2022-01-31,40 to 49,205,1728,4,1937
2022-01-31,50 to 59,158,1434,8,1600
2022-01-31,60 to 69,96,714,7,817
2022-01-31,70 to 79,33,260,11,304
2022-01-31,80 to 89,5,81,12,98
2022-01-31,90+,1,12,8,21
2022-01-31,Unknown,6,3,0,9
2022-01-31,Total,1702,14865,53,16620
2022-02-01,0 to 9,272,2518,1,2791
2022-02-01,10 to 19,289,2231,0,2520
2022-02-01,20 to 29,326,3213,0,3539
2022-02-01,30 to 39,407,2719,2,3128
2022-02-01,40 to 49,223,1734,4,1961
2022-02-01,50 to 59,170,1438,8,1616
2022-02-01,60 to 69,104,719,7,830
2022-02-01,70 to 79,35,260,11,306
2022-02-01,80 to 89,5,81,12,98
2022-02-01,90+,0,13,8,21
2022-02-01,Unknown,4,3,0,7
2022-02-01,Total,1835,14929,53,16817
2022-02-02,0 to 9,288,2526,1,2815
2022-02-02,10 to 19,328,2234,0,2562
2022-02-02,20 to 29,353,3223,0,3576
2022-02-02,30 to 39,422,2732,2,3156
2022-02-02,40 to 49,252,1738,4,1994
2022-02-02,50 to 59,181,1443,8,1632
2022-02-02,60 to 69,103,726,7,836
2022-02-02,70 to 79,38,261,11,310
2022-02-02,80 to 89,5,81,12,98
2022-02-02,90+,0,13,8,21
2022-02-02,Unknown,4,1,0,5
2022-02-02,Total,1974,14978,53,17005
2022-02-03,0 to 9,307,2538,1,2846
2022-02-03,10 to 19,378,2248,0,2626
2022-02-03,20 to 29,389,3231,0,3620
2022-02-03,30 to 39,455,2749,2,3206
2022-02-03,40 to 49,280,1748,4,2032
2022-02-03,50 to 59,209,1446,8,1663
2022-02-03,60 to 69,108,728,7,843
2022-02-03,70 to 79,41,262,11,314
2022-02-03,80 to 89,6,81,12,99
2022-02-03,90+,1,13,8,22
2022-02-03,Unknown,5,1,0,6
2022-02-03,Total,2179,15045,53,17277
2022-02-04,0 to 9,333,2547,1,2881
2022-02-04,10 to 19,416,2258,0,2674
2022-02-04,20 to 29,427,3241,0,3668
2022-02-04,30 to 39,502,2761,2,3265
2022-02-04,40 to 49,307,1757,4,2068
2022-02-04,50 to 59,224,1453,8,1685
2022-02-04,60 to 69,116,731,7,854
2022-02-04,70 to 79,50,262,11,323
2022-02-04,80 to 89,6,81,12,99
2022-02-04,90+,2,13,8,23
2022-02-04,Unknown,5,1,0,6
2022-02-04,Total,2388,15105,53,17546
2022-02-05,0 to 9,340,2568,1,2909
2022-02-05,10 to 19,444,2267,0,2711
2022-02-05,20 to 29,462,3257,0,3719
2022-02-05,30 to 39,523,2787,2,3312
2022-02-05,40 to 49,330,1767,4,2101
2022-02-05,50 to 59,236,1461,8,1705
2022-02-05,60 to 69,117,735,7,859
2022-02-05,70 to 79,51,263,11,325
2022-02-05,80 to 89,7,82,12,101
2022-02-05,90+,2,13,8,23
2022-02-05,Unknown,7,1,0,8
2022-02-05,Total,2519,15201,53,17773
2022-02-06,0 to 9,365,2570,1,2936
2022-02-06,10 to 19,485,2272,0,2757
2022-02-06,20 to 29,498,3262,0,3760
2022-02-06,30 to 39,554,2794,2,3350
2022-02-06,40 to 49,353,1770,4,2127
2022-02-06,50 to 59,258,1464,8,1730
2022-02-06,60 to 69,120,737,7,864
2022-02-06,70 to 79,56,263,11,330
2022-02-06,80 to 89,8,82,12,102
2022-02-06,90+,2,13,8,23
2022-02-06,Unknown,8,1,0,9
2022-02-06,Total,2707,15228,53,17988
2022-02-07,0 to 9,377,2594,1,2972
2022-02-07,10 to 19,525,2283,0,2808
2022-02-07,20 to 29,549,3273,0,3822
2022-02-07,30 to 39,567,2820,2,3389
2022-02-07,40 to 49,374,1779,4,2157
2022-02-07,50 to 59,276,1470,8,1754
2022-02-07,60 to 69,133,740,7,880
2022-02-07,70 to 79,63,265,11,339
2022-02-07,80 to 89,8,82,12,102
2022-02-07,90+,2,13,8,23
2022-02-07,Unknown,6,1,0,7
2022-02-07,Total,2880,15320,53,18253
2022-02-08,0 to 9,407,2608,1,3016
2022-02-08,10 to 19,553,2290,0,2843
2022-02-08,20 to 29,576,3296,0,3872
2022-02-08,30 to 39,596,2835,2,3433
2022-02-08,40 to 49,389,1797,4,2190
2022-02-08,50 to 59,292,1477,8,1777
2022-02-08,60 to 69,140,745,7,892
2022-02-08,70 to 79,64,270,11,345
2022-02-08,80 to 89,10,82,12,104
2022-02-08,90+,2,13,8,23
2022-02-08,Unknown,6,2,0,8
2022-02-08,Total,3035,15415,53,18503
2022-02-09,0 to 9,429,2623,1,3053
2022-02-09,10 to 19,584,2300,0,2884
2022-02-09,20 to 29,640,3316,0,3956
2022-02-09,30 to 39,649,2849,2,3500
2022-02-09,40 to 49,426,1814,4,2244
2022-02-09,50 to 59,324,1479,8,1811
2022-02-09,60 to 69,145,752,7,904
2022-02-09,70 to 79,69,270,11,350
2022-02-09,80 to 89,10,82,12,104
2022-02-09,90+,2,13,8,23
2022-02-09,Unknown,7,1,0,8
2022-02-09,Total,3285,15499,53,18837
2022-02-10,0 to 9,481,2639,1,3121
2022-02-10,10 to 19,650,2315,0,2965
2022-02-10,20 to 29,728,3332,0,4060
2022-02-10,30 to 39,717,2874,2,3593
2022-02-10,40 to 49,465,1828,4,2297
2022-02-10,50 to 59,362,1490,8,1860
2022-02-10,60 to 69,161,755,7,923
2022-02-10,70 to 79,72,271,11,354
2022-02-10,80 to 89,13,82,12,107
2022-02-10,90+,4,13,8,25
2022-02-10,Unknown,7,1,0,8
2022-02-10,Total,3660,15600,53,19313
2022-02-11,0 to 9,535,2648,1,3184
2022-02-11,10 to 19,703,2327,0,3030
2022-02-11,20 to 29,825,3343,0,4168
2022-02-11,30 to 39,807,2888,2,3697
2022-02-11,40 to 49,526,1834,4,2364
2022-02-11,50 to 59,394,1496,8,1898
2022-02-11,60 to 69,168,761,7,936
2022-02-11,70 to 79,73,272,11,356
2022-02-11,80 to 89,16,82,12,110
2022-02-11,90+,4,13,8,25
2022-02-11,Unknown,8,1,0,9
2022-02-11,Total,4059,15665,53,19777
2022-02-13,0 to 9,706,2676,1,3383
2022-02-13,10 to 19,1016,2354,0,3370
2022-02-13,20 to 29,1221,3381,0,4602
2022-02-13,30 to 39,1079,2932,2,4013
2022-02-13,40 to 49,727,1859,4,2590
2022-02-13,50 to 59,528,1520,8,2056
2022-02-13,60 to 69,238,772,7,1017
2022-02-13,70 to 79,110,273,11,394
2022-02-13,80 to 89,23,84,12,119
2022-02-13,90+,8,13,8,29
2022-02-13,Unknown,0,0,0,0
2022-02-13,Total,5656,15864,53,21573
2022-02-14,0 to 9,801,2691,1,3493
2022-02-14,10 to 19,1125,2366,0,3491
2022-02-14,20 to 29,1391,3402,0,4793
2022-02-14,30 to 39,1198,2952,2,4152
2022-02-14,40 to 49,800,1873,4,2677
2022-02-14,50 to 59,577,1535,8,2120
2022-02-14,60 to 69,265,777,7,1049
2022-02-14,70 to 79,115,273,11,399
2022-02-14,80 to 89,27,84,12,123
2022-02-14,90+,10,13,8,31
2022-02-14,Unknown,0,0,0,0
2022-02-14,Total,6309,15966,53,22328
2022-02-15,0 to 9,931,2700,1,3632
2022-02-15,10 to 19,1338,2393,0,3731
2022-02-15,20 to 29,1643,3422,0,5065
2022-02-15,30 to 39,1420,2974,2,4396
2022-02-15,40 to 49,918,1891,4,2813
2022-02-15,50 to 59,645,1557,8,2210
2022-02-15,60 to 69,299,781,7,1087
2022-02-15,70 to 79,128,276,11,415
2022-02-15,80 to 89,32,84,12,128
2022-02-15,90+,11,13,8,32
2022-02-15,Unknown,0,0,0,0
2022-02-15,Total,7365,16091,53,23509
2022-02-16,0 to 9,1103,2715,1,3819
2022-02-16,10 to 19,1624,2429,0,4053
2022-02-16,20 to 29,2016,3440,0,5456
2022-02-16,30 to 39,1660,3014,2,4676
2022-02-16,40 to 49,1055,1920,4,2979
2022-02-16,50 to 59,747,1577,8,2332
2022-02-16,60 to 69,344,790,7,1141
2022-02-16,70 to 79,137,281,11,429
2022-02-16,80 to 89,33,84,12,129
2022-02-16,90+,15,13,8,36
2022-02-16,Unknown,0,0,0,0
2022-02-16,Total,8734,16263,53,25050
2022-02-17,0 to 9,1326,2741,1,4068
2022-02-17,10 to 19,1941,2485,0,4426
2022-02-17,20 to 29,2508,3469,0,5977
2022-02-17,30 to 39,1934,3049,2,4985
2022-02-17,40 to 49,1229,1944,4,3177
2022-02-17,50 to 59,883,1597,8,2488
2022-02-17,60 to 69,394,800,7,1201
2022-02-17,70 to 79,149,287,11,447
2022-02-17,80 to 89,34,84,12,130
2022-02-17,90+,14,14,8,36
2022-02-17,Unknown,0,0,0,0
2022-02-17,Total,10412,16470,53,26935
2022-02-18,0 to 9,1455,2759,1,4215
2022-02-18,10 to 19,2298,2506,0,4804
2022-02-18,20 to 29,3014,3498,0,6512
2022-02-18,30 to 39,2233,3078,2,5313
2022-02-18,40 to 49,1410,1959,4,3373
2022-02-18,50 to 59,992,1612,8,2612
2022-02-18,60 to 69,461,807,7,1275
2022-02-18,70 to 79,174,289,11,474
2022-02-18,80 to 89,40,84,12,136
2022-02-18,90+,15,14,8,37
2022-02-18,Unknown,0,0,0,0
2022-02-18,Total,12092,16606,53,28751
2022-02-19,0 to 9,1727,2787,1,4515
2022-02-19,10 to 19,2860,2535,0,5395
2022-02-19,20 to 29,3551,3530,0,7081
2022-02-19,30 to 39,2570,3113,2,5685
2022-02-19,40 to 49,1617,1980,4,3601
2022-02-19,50 to 59,1134,1627,8,2769
2022-02-19,60 to 69,524,812,7,1343
2022-02-19,70 to 79,201,292,11,504
2022-02-19,80 to 89,56,85,12,153
2022-02-19,90+,19,14,8,41
2022-02-19,Unknown,0,0,0,0
2022-02-19,Total,14259,16775,53,31087
2022-02-20,0 to 9,1948,2802,1,4751
2022-02-20,10 to 19,3405,2557,0,5962
2022-02-20,20 to 29,4101,3549,0,7650
2022-02-20,30 to 39,2881,3141,2,6024
2022-02-20,40 to 49,1833,1995,4,3832
2022-02-20,50 to 59,1278,1637,8,2923
2022-02-20,60 to 69,604,816,7,1427
2022-02-20,70 to 79,227,297,11,535
2022-02-20,80 to 89,71,85,12,168
2022-02-20,90+,23,14,8,45
2022-02-20,Unknown,0,0,0,0
2022-02-20,Total,16371,16893,53,33317
2022-02-21,0 to 9,2198,2829,1,5028
2022-02-21,10 to 19,4152,2594,0,6746
2022-02-21,20 to 29,4801,3590,0,8391
2022-02-21,30 to 39,3322,3176,2,6500
2022-02-21,40 to 49,2093,2017,5,4115
2022-02-21,50 to 59,1434,1647,9,3090
2022-02-21,60 to 69,666,827,8,1501
2022-02-21,70 to 79,256,300,11,567
2022-02-21,80 to 89,81,86,12,179
2022-02-21,90+,23,14,8,45
2022-02-21,Unknown,0,0,0,0
2022-02-21,Total,19026,17080,56,36162
2022-02-22,0 to 9,2478,2854,1,5333
2022-02-22,10 to 19,5113,2628,0,7741
2022-02-22,20 to 29,5559,3631,0,9190
2022-02-22,30 to 39,3689,3217,2,6908
2022-02-22,40 to 49,2370,2041,5,4416
2022-02-22,50 to 59,1631,1661,9,3301
2022-02-22,60 to 69,762,833,8,1603
2022-02-22,70 to 79,296,302,11,609
2022-02-22,80 to 89,100,86,12,198
2022-02-22,90+,24,14,8,46
2022-02-22,Unknown,0,0,0,0
2022-02-22,Total,22022,17267,56,39345
2022-02-23,0 to 9,2782,2875,1,5658
2022-02-23,10 to 19,6422,2666,0,9088
2022-02-23,20 to 29,7576,3671,0,11247
2022-02-23,30 to 39,4832,3248,2,8082
2022-02-23,40 to 49,2968,2076,5,5049
2022-02-23,50 to 59,1969,1679,9,3657
2022-02-23,60 to 69,916,843,8,1767
2022-02-23,70 to 79,342,309,11,662
2022-02-23,80 to 89,117,86,12,215
2022-02-23,90+,25,15,8,48
2022-02-23,Unknown,0,0,0,0
2022-02-23,Total,27949,17468,56,45473
2022-02-24,0 to 9,3548,2909,1,6458
2022-02-24,10 to 19,8927,2707,0,11634
2022-02-24,20 to 29,11271,3717,0,14988
2022-02-24,30 to 39,7012,3309,2,10323
2022-02-24,40 to 49,4278,2106,5,6389
2022-02-24,50 to 59,2776,1705,9,4490
2022-02-24,60 to 69,1255,852,8,2115
2022-02-24,70 to 79,466,314,11,791
2022-02-24,80 to 89,158,87,12,257
2022-02-24,90+,29,15,8,52
2022-02-24,Unknown,0,0,0,0
2022-02-24,Total,39720,17721,56,57497
2022-02-25,0 to 9,4679,2942,1,7622
2022-02-25,10 to 19,11939,2751,0,14690
2022-02-25,20 to 29,14882,3766,0,18648
2022-02-25,30 to 39,9403,3346,2,12751
2022-02-25,40 to 49,5841,2142,5,7988
2022-02-25,50 to 59,3796,1720,9,5525
2022-02-25,60 to 69,1698,859,8,2565
2022-02-25,70 to 79,632,319,11,962
2022-02-25,80 to 89,215,87,12,314
2022-02-25,90+,34,15,8,57
2022-02-25,Unknown,0,0,0,0
2022-02-25,Total,53119,17947,56,71122
2022-02-26,0 to 9,6168,2961,1,9130
2022-02-26,10 to 19,16032,2778,0,18810
2022-02-26,20 to 29,18438,3800,0,22238
2022-02-26,30 to 39,11801,3386,2,15189
2022-02-26,40 to 49,7445,2167,5,9617
2022-02-26,50 to 59,4810,1732,9,6551
2022-02-26,60 to 69,2157,864,8,3029
2022-02-26,70 to 79,813,322,11,1146
2022-02-26,80 to 89,260,89,12,361
2022-02-26,90+,44,15,8,67
2022-02-26,Unknown,0,0,0,0
2022-02-26,Total,67968,18114,56,86138
2022-02-27,0 to 9,7504,2997,1,10502
2022-02-27,10 to 19,19470,2814,0,22284
2022-02-27,20 to 29,22008,3844,0,25852
2022-02-27,30 to 39,14414,3430,2,17846
2022-02-27,40 to 49,9231,2190,5,11426
2022-02-27,50 to 59,5817,1756,9,7582
2022-02-27,60 to 69,2653,871,8,3532
2022-02-27,70 to 79,973,325,11,1309
2022-02-27,80 to 89,306,90,12,408
2022-02-27,90+,57,15,8,80
2022-02-27,Unknown,0,0,0,0
2022-02-27,Total,82433,18332,56,100821
2022-02-28,0 to 9,9152,3038,1,12191
2022-02-28,10 to 19,23418,2868,0,26286
2022-02-28,20 to 29,26321,3910,0,30231
2022-02-28,30 to 39,17530,3474,2,21006
2022-02-28,40 to 49,11474,2228,5,13707
2022-02-28,50 to 59,7339,1776,9,9124
2022-02-28,60 to 69,3314,881,8,4203
2022-02-28,70 to 79,1162,333,11,1506
2022-02-28,80 to 89,370,90,12,472
2022-02-28,90+,63,15,8,86
2022-02-28,Unknown,0,0,0,0
2022-02-28,Total,100143,18613,56,118812
2022-03-01,0 to 9,11550,3059,1,14610
2022-03-01,10 to 19,28356,2890,0,31246
2022-03-01,20 to 29,32546,3938,0,36484
2022-03-01,30 to 39,21828,3495,2,25325
2022-03-01,40 to 49,14319,2241,5,16565
2022-03-01,50 to 59,9216,1791,9,11016
2022-03-01,60 to 69,4248,890,8,5146
2022-03-01,70 to 79,1480,337,11,1828
2022-03-01,80 to 89,482,92,12,586
2022-03-01,90+,88,15,8,111
2022-03-01,Unknown,1,0,0,1
2022-03-01,Total,124114,18748,56,142918
2022-03-02,0 to 9,13588,3134,1,16723
2022-03-02,10 to 19,32878,2963,0,35841
2022-03-02,20 to 29,38613,4056,0,42669
2022-03-02,30 to 39,25949,3590,2,29541
2022-03-02,40 to 49,17136,2319,5,19460
2022-03-02,50 to 59,11085,1838,9,12932
2022-03-02,60 to 69,5091,912,8,6011
2022-03-02,70 to 79,1781,343,11,2135
2022-03-02,80 to 89,552,93,12,657
2022-03-02,90+,105,15,8,128
2022-03-02,Unknown,1,0,0,1
2022-03-02,Total,146779,19263,56,166098
2022-03-03,0 to 9,13956,5028,1,18985
2022-03-03,10 to 19,33422,6752,0,40174
2022-03-03,20 to 29,39915,8407,0,48322
2022-03-03,30 to 39,27242,6503,2,33747
2022-03-03,40 to 49,18178,4104,7,22289
2022-03-03,50 to 59,11710,3090,9,14809
2022-03-03,60 to 69,5457,1494,8,6959
2022-03-03,70 to 79,1918,557,12,2487
2022-03-03,80 to 89,579,167,15,761
2022-03-03,90+,101,36,9,146
2022-03-03,Unknown,1,0,0,1
2022-03-03,Total,152479,36138,63,188680
2022-03-04,0 to 9,15603,5350,1,20954
2022-03-04,10 to 19,35924,7790,0,43714
2022-03-04,20 to 29,43397,9291,0,52688
2022-03-04,30 to 39,30282,6953,2,37237
2022-03-04,40 to 49,20428,4449,7,24884
2022-03-04,50 to 59,13159,3317,9,16485
2022-03-04,60 to 69,6174,1606,8,7788
2022-03-04,70 to 79,2164,602,12,2778
2022-03-04,80 to 89,667,185,15,867
2022-03-04,90+,120,37,9,166
2022-03-04,Unknown,1,0,0,1
2022-03-04,Total,167919,39580,63,207562
2022-03-05,0 to 9,17058,5688,1,22747
2022-03-05,10 to 19,37872,8793,0,46665
2022-03-05,20 to 29,45846,10180,0,56026
2022-03-05,30 to 39,32426,7550,2,39978
2022-03-05,40 to 49,22110,4799,7,26916
2022-03-05,50 to 59,14265,3546,9,17820
2022-03-05,60 to 69,6700,1725,8,8433
2022-03-05,70 to 79,2398,645,12,3055
2022-03-05,80 to 89,730,201,17,948
2022-03-05,90+,130,39,9,178
2022-03-05,Unknown,1,0,0,1
2022-03-05,Total,179536,43166,65,222767
2022-03-06,0 to 9,18509,6058,1,24568
2022-03-06,10 to 19,40217,9986,0,50203
2022-03-06,20 to 29,48288,11509,0,59797
2022-03-06,30 to 39,35057,8212,2,43271
2022-03-06,40 to 49,24056,5225,7,29288
2022-03-06,50 to 59,15569,3849,9,19427
2022-03-06,60 to 69,7346,1847,8,9201
2022-03-06,70 to 79,2637,700,12,3349
2022-03-06,80 to 89,786,219,17,1022
2022-03-06,90+,141,41,9,191
2022-03-06,Unknown,2,0,0,2
2022-03-06,Total,192608,47646,65,240319
2022-03-07,0 to 9,19147,7848,1,26996
2022-03-07,10 to 19,39480,15350,0,54830
2022-03-07,20 to 29,46612,18416,0,65028
2022-03-07,30 to 39,35170,12592,2,47764
2022-03-07,40 to 49,24527,8011,7,32545
2022-03-07,50 to 59,16103,5532,9,21644
2022-03-07,60 to 69,7792,2563,8,10363
2022-03-07,70 to 79,2757,954,12,3723
2022-03-07,80 to 89,834,297,17,1148
2022-03-07,90+,155,48,9,212
2022-03-07,Unknown,2,0,0,2
2022-03-07,Total,192579,71611,65,264255
2022-03-08,0 to 9,20251,9057,1,29309
2022-03-08,10 to 19,40529,18562,0,59091
2022-03-08,20 to 29,48523,21589,0,70112
2022-03-08,30 to 39,37076,14816,2,51894
2022-03-08,40 to 49,26283,9446,7,35736
2022-03-08,50 to 59,17124,6460,9,23593
2022-03-08,60 to 69,8452,2980,8,11440
2022-03-08,70 to 79,2941,1124,12,4077
2022-03-08,80 to 89,908,338,17,1263
2022-03-08,90+,168,56,9,233
2022-03-08,Unknown,2,0,0,2
2022-03-08,Total,202257,84428,65,286750
2022-03-10,0 to 9,21632,12200,1,33833
2022-03-10,10 to 19,40498,26306,0,66804
2022-03-10,20 to 29,48627,30268,0,78895
2022-03-10,30 to 39,38632,21036,2,59670
2022-03-10,40 to 49,28127,13722,8,41857
2022-03-10,50 to 59,18444,9128,8,27580
2022-03-10,60 to 69,9273,4203,10,13486
2022-03-10,70 to 79,3349,1492,19,4860
2022-03-10,80 to 89,1080,452,26,1558
2022-03-10,90+,204,76,12,292
2022-03-10,Unknown,1,0,0,1
2022-03-10,Total,209867,118883,86,328836
2022-03-11,0 to 9,21984,14482,1,36467
2022-03-11,10 to 19,39415,30943,0,70358
2022-03-11,20 to 29,46441,35867,0,82308
2022-03-11,30 to 39,37927,24988,2,62917
2022-03-11,40 to 49,28116,16369,8,44493
2022-03-11,50 to 59,18428,10909,9,29346
2022-03-11,60 to 69,9340,5073,10,14423
2022-03-11,70 to 79,3440,1794,21,5255
2022-03-11,80 to 89,1112,552,28,1692
2022-03-11,90+,201,101,14,316
2022-03-11,Unknown,1,0,0,1
2022-03-11,Total,206405,141078,93,347576
2022-03-12,0 to 9,21808,16618,1,38427
2022-03-12,10 to 19,37511,35602,0,73113
2022-03-12,20 to 29,42773,42185,0,84958
2022-03-12,30 to 39,36105,29291,2,65398
2022-03-12,40 to 49,27278,19294,8,46580
2022-03-12,50 to 59,17881,12845,9,30735
2022-03-12,60 to 69,9203,5942,13,15158
2022-03-12,70 to 79,3461,2105,22,5588
2022-03-12,80 to 89,1154,623,29,1806
2022-03-12,90+,212,116,17,345
2022-03-12,Unknown,1,0,0,1
2022-03-12,Total,197387,164621,101,362109
2022-03-13,0 to 9,21651,18848,1,40500
2022-03-13,10 to 19,36195,39919,0,76114
2022-03-13,20 to 29,39893,47842,0,87735
2022-03-13,30 to 39,34723,33493,2,68218
2022-03-13,40 to 49,26732,22112,8,48852
2022-03-13,50 to 59,17456,14721,9,32186
2022-03-13,60 to 69,9060,6886,13,15959
2022-03-13,70 to 79,3396,2445,22,5863
2022-03-13,80 to 89,1145,720,30,1895
2022-03-13,90+,215,130,17,362
2022-03-13,Unknown,1,0,0,1
2022-03-13,Total,190467,187116,102,377685
2022-03-14,0 to 9,22574,20804,1,43379
2022-03-14,10 to 19,36850,43459,0,80309
2022-03-14,20 to 29,39392,52214,0,91606
2022-03-14,30 to 39,35128,36978,2,72108
2022-03-14,40 to 49,27215,24701,8,51924
2022-03-14,50 to 59,17800,16398,9,34207
2022-03-14,60 to 69,9352,7711,13,17076
2022-03-14,70 to 79,3528,2738,22,6288
2022-03-14,80 to 89,1195,825,30,2050
2022-03-14,90+,230,147,17,394
2022-03-14,Unknown,1,0,0,1
2022-03-14,Total,193265,205975,102,399342
2022-03-16,0 to 9,23974,24354,1,48329
2022-03-16,10 to 19,37655,49907,0,87562
2022-03-16,20 to 29,39733,59289,0,99022
2022-03-16,30 to 39,36245,42979,3,79227
2022-03-16,40 to 49,28539,29080,9,57628
2022-03-16,50 to 59,18452,19329,11,37792
2022-03-16,60 to 69,9930,9116,16,19062
2022-03-16,70 to 79,3710,3304,28,7042
2022-03-16,80 to 89,1332,972,41,2345
2022-03-16,90+,276,165,26,467
2022-03-16,Unknown,1,0,0,1
2022-03-16,Total,199847,238495,135,438477
2022-03-17,0 to 9,16329,33832,1,50162
2022-03-17,10 to 19,23301,66796,0,90097
2022-03-17,20 to 29,22526,78881,0,101407
2022-03-17,30 to 39,22054,59661,3,81718
2022-03-17,40 to 49,17951,41847,9,59807
2022-03-17,50 to 59,11670,27562,11,39243
2022-03-17,60 to 69,6382,13466,16,19864
2022-03-17,70 to 79,2511,4832,29,7372
2022-03-17,80 to 89,935,1519,43,2497
2022-03-17,90+,208,268,26,502
2022-03-17,Unknown,0,1,0,1
2022-03-17,Total,123867,328665,138,452670
2022-03-18,0 to 9,16694,36466,1,53161
2022-03-18,10 to 19,23038,70354,0,93392
2022-03-18,20 to 29,22191,82302,0,104493
2022-03-18,30 to 39,22078,62913,3,84994
2022-03-18,40 to 49,17957,44481,9,62447
2022-03-18,50 to 59,11680,29330,11,41021
2022-03-18,60 to 69,6343,14404,17,20764
2022-03-18,70 to 79,2531,5226,29,7786
2022-03-18,80 to 89,936,1649,46,2631
2022-03-18,90+,217,290,28,535
2022-03-18,Unknown,0,1,0,1
2022-03-18,Total,123665,347416,144,471225
2022-03-19,0 to 9,16611,38424,1,55036
2022-03-19,10 to 19,22524,73107,0,95631
2022-03-19,20 to 29,21464,84952,0,106416
2022-03-19,30 to 39,21715,65393,3,87111
2022-03-19,40 to 49,17657,46565,9,64231
2022-03-19,50 to 59,11438,30720,13,42171
2022-03-19,60 to 69,6176,15143,17,21336
2022-03-19,70 to 79,2427,5557,31,8015
2022-03-19,80 to 89,906,1758,48,2712
2022-03-19,90+,216,317,29,562
2022-03-19,Unknown,0,1,0,1
2022-03-19,Total,121134,361937,151,483222
2022-03-20,0 to 9,16661,40497,1,57159
2022-03-20,10 to 19,22297,76107,0,98404
2022-03-20,20 to 29,21144,87727,1,108872
2022-03-20,30 to 39,21496,68217,3,89716
2022-03-20,40 to 49,17553,48837,9,66399
2022-03-20,50 to 59,11265,32170,13,43448
2022-03-20,60 to 69,6051,15946,18,22015
2022-03-20,70 to 79,2456,5831,32,8319
2022-03-20,80 to 89,915,1845,53,2813
2022-03-20,90+,221,331,33,585
2022-03-20,Unknown,0,1,0,1
2022-03-20,Total,120059,377509,163,497731
2022-03-21,0 to 9,16986,43377,1,60364
2022-03-21,10 to 19,22095,80305,0,102400
2022-03-21,20 to 29,20809,91600,1,112410
2022-03-21,30 to 39,21285,72108,3,93396
2022-03-21,40 to 49,17570,51908,9,69487
2022-03-21,50 to 59,11112,34191,14,45317
2022-03-21,60 to 69,5887,17058,22,22967
2022-03-21,70 to 79,2471,6255,37,8763
2022-03-21,80 to 89,905,1996,57,2958
2022-03-21,90+,226,363,33,622
2022-03-21,Unknown,0,1,0,1
2022-03-21,Total,119346,399162,177,518685
2022-03-22,0 to 9,17301,45946,1,63248
2022-03-22,10 to 19,22096,83964,0,106060
2022-03-22,20 to 29,20698,95309,1,116008
2022-03-22,30 to 39,21473,75567,4,97044
2022-03-22,40 to 49,17643,54744,9,72396
2022-03-22,50 to 59,11177,35946,14,47137
2022-03-22,60 to 69,5885,18042,23,23950
2022-03-22,70 to 79,2547,6610,38,9195
2022-03-22,80 to 89,927,2140,59,3126
2022-03-22,90+,242,397,35,674
2022-03-22,Unknown,0,1,0,1
2022-03-22,Total,119989,418666,184,538839
2022-03-23,0 to 9,17371,48324,1,65696
2022-03-23,10 to 19,21657,87558,0,109215
2022-03-23,20 to 29,20410,99014,1,119425
2022-03-23,30 to 39,21293,79219,4,100516
2022-03-23,40 to 49,17512,57612,9,75133
2022-03-23,50 to 59,11074,37772,15,48861
2022-03-23,60 to 69,5821,19043,23,24887
2022-03-23,70 to 79,2561,7003,39,9603
2022-03-23,80 to 89,926,2289,62,3277
2022-03-23,90+,244,434,38,716
2022-03-23,Unknown,0,1,0,1
2022-03-23,Total,118869,438269,192,557330
2022-03-24,0 to 9,17653,50369,1,68023
2022-03-24,10 to 19,22014,90023,0,112037
2022-03-24,20 to 29,20701,101411,1,122113
2022-03-24,30 to 39,21556,81715,5,103276
2022-03-24,40 to 49,17895,59722,9,77626
2022-03-24,50 to 59,11142,39190,15,50347
2022-03-24,60 to 69,5910,19787,25,25722
2022-03-24,70 to 79,2586,7312,42,9940
2022-03-24,80 to 89,926,2423,64,3413
2022-03-24,90+,242,465,39,746
2022-03-24,Unknown,0,1,0,1
2022-03-24,Total,120625,452418,201,573244
2022-03-25,0 to 9,17431,52779,1,70211
2022-03-25,10 to 19,21633,92877,0,114510
2022-03-25,20 to 29,20388,104009,1,124398
2022-03-25,30 to 39,21182,84509,5,105696
2022-03-25,40 to 49,17706,62106,10,79822
2022-03-25,50 to 59,10914,40781,16,51711
2022-03-25,60 to 69,5830,20623,28,26481
2022-03-25,70 to 79,2565,7685,46,10296
2022-03-25,80 to 89,944,2550,69,3563
2022-03-25,90+,244,493,41,778
2022-03-25,Unknown,0,1,0,1
2022-03-25,Total,118837,468413,217,587467
2022-03-26,0 to 9,16716,55035,1,71752
2022-03-26,10 to 19,20720,95631,0,116351
2022-03-26,20 to 29,19580,106411,1,125992
2022-03-26,30 to 39,20376,87106,5,107487
2022-03-26,40 to 49,17092,64221,10,81323
2022-03-26,50 to 59,10603,42151,16,52770
2022-03-26,60 to 69,5725,21310,29,27064
2022-03-26,70 to 79,2527,7972,46,10545
2022-03-26,80 to 89,941,2649,72,3662
2022-03-26,90+,231,524,43,798
2022-03-26,Unknown,0,1,0,1
2022-03-26,Total,114511,483011,223,597745
2022-03-27,0 to 9,16677,57154,1,73832
2022-03-27,10 to 19,20313,98400,0,118713
2022-03-27,20 to 29,19105,108860,1,127966
2022-03-27,30 to 39,20119,89705,5,109829
2022-03-27,40 to 49,16875,66383,10,83268
2022-03-27,50 to 59,10532,43428,16,53976
2022-03-27,60 to 69,5740,21988,29,27757
2022-03-27,70 to 79,2465,8272,50,10787
2022-03-27,80 to 89,920,2744,74,3738
2022-03-27,90+,230,545,45,820
2022-03-27,Unknown,0,1,0,1
2022-03-27,Total,112976,497480,231,610687
2022-03-28,0 to 9,16308,60357,1,76666
2022-03-28,10 to 19,19401,102398,0,121799
2022-03-28,20 to 29,18303,112401,1,130705
2022-03-28,30 to 39,19410,93386,6,112802
2022-03-28,40 to 49,16286,69473,10,85769
2022-03-28,50 to 59,10263,45295,17,55575
2022-03-28,60 to 69,5709,22936,33,28678
2022-03-28,70 to 79,2385,8707,58,11150
2022-03-28,80 to 89,928,2883,81,3892
2022-03-28,90+,234,568,59,861
2022-03-28,Unknown,0,1,0,1
2022-03-28,Total,109227,518405,266,627898
2022-03-29,0 to 9,15722,63240,1,78963
2022-03-29,10 to 19,18518,106057,0,124575
2022-03-29,20 to 29,17488,115998,1,133487
2022-03-29,30 to 39,18629,97031,6,115666
2022-03-29,40 to 49,15734,72380,10,88124
2022-03-29,50 to 59,9946,47116,17,57079
2022-03-29,60 to 69,5601,23918,33,29552
2022-03-29,70 to 79,2304,9136,62,11502
2022-03-29,80 to 89,899,3043,86,4028
2022-03-29,90+,224,612,62,898
2022-03-29,Unknown,0,1,0,1
2022-03-29,Total,105065,538532,278,643875
2022-03-30,0 to 9,15346,65690,1,81037
2022-03-30,10 to 19,17834,109208,0,127042
2022-03-30,20 to 29,16702,119416,1,136119
2022-03-30,30 to 39,17985,100502,6,118493
2022-03-30,40 to 49,15375,75118,10,90503
2022-03-30,50 to 59,9703,48840,19,58562
2022-03-30,60 to 69,5530,24851,37,30418
2022-03-30,70 to 79,2261,9538,65,11864
2022-03-30,80 to 89,920,3186,91,4197
2022-03-30,90+,219,651,69,939
2022-03-30,Unknown,0,1,0,1
2022-03-30,Total,101875,557001,299,659175
2022-03-31,0 to 9,15031,68020,1,83052
2022-03-31,10 to 19,17189,112031,0,129220
2022-03-31,20 to 29,16196,122104,1,138301
2022-03-31,30 to 39,17673,103266,6,120945
2022-03-31,40 to 49,14948,77611,10,92569
2022-03-31,50 to 59,9568,50326,20,59914
2022-03-31,60 to 69,5455,25681,40,31176
2022-03-31,70 to 79,2271,9871,71,12213
2022-03-31,80 to 89,931,3321,93,4345
2022-03-31,90+,224,680,72,976
2022-03-31,Unknown,0,1,0,1
2022-03-31,Total,99486,572912,314,672712
2022-04-02,0 to 9,14323,71953,1,86277
2022-04-02,10 to 19,16344,116396,0,132740
2022-04-02,20 to 29,15247,126066,1,141314
2022-04-02,30 to 39,16953,107540,8,124501
2022-04-02,40 to 49,14284,81386,10,95680
2022-04-02,50 to 59,9265,52694,22,61981
2022-04-02,60 to 69,5290,27023,44,32357
2022-04-02,70 to 79,2242,10453,81,12776
2022-04-02,80 to 89,898,3557,106,4561
2022-04-02,90+,232,722,77,1031
2022-04-02,Unknown,0,1,0,1
2022-04-02,Total,95078,597791,350,693219
2022-04-03,0 to 9,13940,73913,1,87854
2022-04-03,10 to 19,15777,118686,0,134463
2022-04-03,20 to 29,14946,127957,1,142904
2022-04-03,30 to 39,16479,109832,8,126319
2022-04-03,40 to 49,14016,83238,10,97264
2022-04-03,50 to 59,9071,53923,23,63017
2022-04-03,60 to 69,5226,27691,46,32963
2022-04-03,70 to 79,2204,10702,83,12989
2022-04-03,80 to 89,900,3629,109,4638
2022-04-03,90+,230,743,82,1055
2022-04-03,Unknown,0,1,0,1
2022-04-03,Total,92789,610315,363,703467
2022-04-04,0 to 9,13378,76662,1,90041
2022-04-04,10 to 19,15154,121795,0,136949
2022-04-04,20 to 29,14327,130695,1,145023
2022-04-04,30 to 39,16029,112792,8,128829
2022-04-04,40 to 49,13578,85751,11,99340
2022-04-04,50 to 59,8868,55552,23,64443
2022-04-04,60 to 69,5139,28628,51,33818
2022-04-04,70 to 79,2202,11066,85,13353
2022-04-04,80 to 89,869,3782,117,4768
2022-04-04,90+,216,780,89,1085
2022-04-04,Unknown,0,1,0,1
2022-04-04,Total,89760,627504,386,717650
2022-04-05,0 to 9,12997,78959,1,91957
2022-04-05,10 to 19,14416,124571,0,138987
2022-04-05,20 to 29,13610,133481,1,147092
2022-04-05,30 to 39,15432,115655,8,131095
2022-04-05,40 to 49,13061,88109,11,101181
2022-04-05,50 to 59,8613,57054,24,65691
2022-04-05,60 to 69,4988,29503,54,34545
2022-04-05,70 to 79,2200,11416,88,13704
2022-04-05,80 to 89,869,3917,121,4907
2022-04-05,90+,217,812,96,1125
2022-04-05,Unknown,0,1,0,1
2022-04-05,Total,86403,643478,404,730285
2022-04-06,0 to 9,12543,81033,1,93577
2022-04-06,10 to 19,13684,127040,0,140724
2022-04-06,20 to 29,13007,136110,1,149118
2022-04-06,30 to 39,14770,118478,10,133258
2022-04-06,40 to 49,12466,90489,11,102966
2022-04-06,50 to 59,8296,58535,27,66858
2022-04-06,60 to 69,4887,30368,55,35310
2022-04-06,70 to 79,2107,11775,93,13975
2022-04-06,80 to 89,828,4084,127,5039
2022-04-06,90+,211,849,101,1161
2022-04-06,Unknown,0,1,0,1
2022-04-06,Total,82799,658762,426,741987
2022-04-08,0 to 9,11394,84880,1,96275
2022-04-08,10 to 19,12394,131201,1,143596
2022-04-08,20 to 29,11970,140017,1,151988
2022-04-08,30 to 39,13598,122992,10,136600
2022-04-08,40 to 49,11444,94308,13,105765
2022-04-08,50 to 59,7584,61050,27,68661
2022-04-08,60 to 69,4709,31764,58,36531
2022-04-08,70 to 79,2070,12447,96,14613
2022-04-08,80 to 89,790,4352,133,5275
2022-04-08,90+,217,913,105,1235
2022-04-08,Unknown,0,1,0,1
2022-04-08,Total,76170,683925,445,760540
2022-04-09,0 to 9,11095,86269,1,97365
2022-04-09,10 to 19,11959,132737,1,144697
2022-04-09,20 to 29,11639,141310,1,152950
2022-04-09,30 to 39,13351,124485,10,137846
2022-04-09,40 to 49,11079,95661,14,106754
2022-04-09,50 to 59,7337,61950,28,69315
2022-04-09,60 to 69,4594,32297,61,36952
2022-04-09,70 to 79,2040,12680,98,14818
2022-04-09,80 to 89,775,4431,135,5341
2022-04-09,90+,218,930,108,1256
2022-04-09,Unknown,0,1,0,1
2022-04-09,Total,74087,692751,457,767295
2022-04-10,0 to 9,10627,87849,1,98477
2022-04-10,10 to 19,11527,134460,1,145988
2022-04-10,20 to 29,11213,142899,1,154113
2022-04-10,30 to 39,12982,126302,10,139294
2022-04-10,40 to 49,10634,97248,14,107896
2022-04-10,50 to 59,7072,62986,28,70086
2022-04-10,60 to 69,4424,32899,63,37386
2022-04-10,70 to 79,2016,12892,101,15009
2022-04-10,80 to 89,762,4504,139,5405
2022-04-10,90+,209,953,111,1273
2022-04-10,Unknown,0,1,0,1
2022-04-10,Total,71466,702993,469,774928
2022-04-11,0 to 9,10052,90095,1,100148
2022-04-11,10 to 19,10862,136933,1,147796
2022-04-11,20 to 29,10859,145033,1,155893
2022-04-11,30 to 39,12410,128826,10,141246
2022-04-11,40 to 49,10183,99295,14,109492
2022-04-11,50 to 59,6780,64414,30,71224
2022-04-11,60 to 69,4286,33723,63,38072
2022-04-11,70 to 79,1994,13251,104,15349
2022-04-11,80 to 89,762,4626,144,5532
2022-04-11,90+,212,978,115,1305
2022-04-11,Unknown,0,1,0,1
2022-04-11,Total,68400,717175,483,786058
2022-04-12,0 to 9,9446,92013,1,101460
2022-04-12,10 to 19,10328,138971,1,149300
2022-04-12,20 to 29,10400,147101,1,157502
2022-04-12,30 to 39,11910,131077,10,142997
2022-04-12,40 to 49,9689,101152,16,110857
2022-04-12,50 to 59,6498,65654,32,72184
2022-04-12,60 to 69,4162,34457,65,38684
2022-04-12,70 to 79,1919,13597,107,15623
2022-04-12,80 to 89,745,4765,148,5658
2022-04-12,90+,212,1012,116,1340
2022-04-12,Unknown,0,1,0,1
2022-04-12,Total,65309,729800,497,795606
2022-04-13,0 to 9,9097,93575,1,102673
2022-04-13,10 to 19,9985,140723,1,150709
2022-04-13,20 to 29,10072,149113,1,159186
2022-04-13,30 to 39,11568,133245,10,144823
2022-04-13,40 to 49,9323,102948,16,112287
2022-04-13,50 to 59,6301,66828,32,73161
2022-04-13,60 to 69,3992,35244,67,39303
2022-04-13,70 to 79,1936,13871,113,15920
2022-04-13,80 to 89,755,4890,153,5798
2022-04-13,90+,211,1048,120,1379
2022-04-13,Unknown,0,1,0,1
2022-04-13,Total,63240,741486,514,805240
2022-04-14,0 to 9,8664,94943,1,103608
2022-04-14,10 to 19,9515,142258,1,151774
2022-04-14,20 to 29,9697,150724,1,160422
2022-04-14,30 to 39,11143,135071,10,146224
2022-04-14,40 to 49,9103,104445,17,113565
2022-04-14,50 to 59,6223,67810,35,74068
2022-04-14,60 to 69,3865,35912,67,39844
2022-04-14,70 to 79,1911,14192,122,16225
2022-04-14,80 to 89,757,5010,158,5925
2022-04-14,90+,201,1091,122,1414
2022-04-14,Unknown,0,1,0,1
2022-04-14,Total,61079,751457,534,813070
2022-04-15,0 to 9,8132,96273,1,104406
2022-04-15,10 to 19,9038,143595,2,152635
2022-04-15,20 to 29,9340,151986,1,161327
2022-04-15,30 to 39,10694,136588,10,147292
2022-04-15,40 to 49,8679,105748,17,114444
2022-04-15,50 to 59,6004,68627,35,74666
2022-04-15,60 to 69,3720,36467,67,40254
2022-04-15,70 to 79,1796,14502,124,16422
2022-04-15,80 to 89,714,5122,161,5997
2022-04-15,90+,197,1116,125,1438
2022-04-15,Unknown,0,1,0,1
2022-04-15,Total,58314,760025,543,818882
2022-04-16,0 to 9,7854,97364,1,105219
2022-04-16,10 to 19,8812,144699,2,153513
2022-04-16,20 to 29,9296,152949,2,162247
2022-04-16,30 to 39,10478,137836,10,148324
2022-04-16,40 to 49,8602,106738,17,115357
2022-04-16,50 to 59,5994,69282,35,75311
2022-04-16,60 to 69,3732,36887,67,40686
2022-04-16,70 to 79,1808,14703,126,16637
2022-04-16,80 to 89,749,5185,168,6102
2022-04-16,90+,207,1137,126,1470
2022-04-16,Unknown,0,1,0,1
2022-04-16,Total,57532,766781,554,824867
2022-04-17,0 to 9,7542,98476,1,106019
2022-04-17,10 to 19,8473,145990,2,154465
2022-04-17,20 to 29,9164,154117,2,163283
2022-04-17,30 to 39,10201,139284,10,149495
2022-04-17,40 to 49,8387,107879,17,116283
2022-04-17,50 to 59,5881,70052,35,75968
2022-04-17,60 to 69,3723,37322,67,41112
2022-04-17,70 to 79,1830,14890,129,16849
2022-04-17,80 to 89,765,5246,174,6185
2022-04-17,90+,211,1151,127,1489
2022-04-17,Unknown,0,1,0,1
2022-04-17,Total,56177,774408,564,831149
2022-04-18,0 to 9,6769,100148,1,106918
2022-04-18,10 to 19,7880,147793,2,155675
2022-04-18,20 to 29,8931,155898,2,164831
2022-04-18,30 to 39,9781,141231,10,151022
2022-04-18,40 to 49,8065,109472,17,117554
2022-04-18,50 to 59,5632,71189,35,76856
2022-04-18,60 to 69,3628,38004,67,41699
2022-04-18,70 to 79,1770,15227,130,17127
2022-04-18,80 to 89,706,5368,178,6252
2022-04-18,90+,210,1182,128,1520
2022-04-18,Unknown,0,1,0,1
2022-04-18,Total,53372,785513,570,839455
2022-04-19,0 to 9,6689,101459,1,108149
2022-04-19,10 to 19,7884,149292,2,157178
2022-04-19,20 to 29,9374,157500,2,166876
2022-04-19,30 to 39,10180,142981,10,153171
2022-04-19,40 to 49,8322,110839,18,119179
2022-04-19,50 to 59,5961,72144,37,78142
2022-04-19,60 to 69,3852,38611,71,42534
2022-04-19,70 to 79,1892,15495,130,17517
2022-04-19,80 to 89,749,5491,180,6420
2022-04-19,90+,235,1214,131,1580
2022-04-19,Unknown,0,1,0,1
2022-04-19,Total,55138,795027,582,850747
2022-04-20,0 to 9,6493,102673,1,109167
2022-04-20,10 to 19,7825,150705,2,158532
2022-04-20,20 to 29,9691,159189,2,168882
2022-04-20,30 to 39,10247,144810,10,155067
2022-04-20,40 to 49,8436,112268,18,120722
2022-04-20,50 to 59,6158,73120,39,79317
2022-04-20,60 to 69,4009,39231,73,43313
2022-04-20,70 to 79,1966,15790,132,17888
2022-04-20,80 to 89,775,5621,188,6584
2022-04-20,90+,260,1250,135,1645
2022-04-20,Unknown,0,1,0,1
2022-04-20,Total,55860,804658,600,861118
2022-04-21,0 to 9,6535,103607,1,110143
2022-04-21,10 to 19,8009,151773,3,159785
2022-04-21,20 to 29,10033,160435,2,170470
2022-04-21,30 to 39,10526,146214,10,156750
2022-04-21,40 to 49,8642,113548,18,122208
2022-04-21,50 to 59,6379,74026,39,80444
2022-04-21,60 to 69,4235,39769,73,44077
2022-04-21,70 to 79,2052,16089,135,18276
2022-04-21,80 to 89,802,5743,193,6738
2022-04-21,90+,278,1284,136,1698
2022-04-21,Unknown,0,2,0,2
2022-04-21,Total,57491,812490,610,870591
2022-04-22,0 to 9,6639,104405,2,111046
2022-04-22,10 to 19,8178,152635,3,160816
2022-04-22,20 to 29,10380,161343,3,171726
2022-04-22,30 to 39,10777,147285,10,158072
2022-04-22,40 to 49,8963,114425,18,123406
2022-04-22,50 to 59,6846,74624,39,81509
2022-04-22,60 to 69,4499,40176,76,44751
2022-04-22,70 to 79,2194,16282,137,18613
2022-04-22,80 to 89,878,5807,198,6883
2022-04-22,90+,308,1302,141,1751
2022-04-22,Unknown,0,2,0,2
2022-04-22,Total,59662,818286,627,878575
2022-04-23,0 to 9,6445,105220,2,111667
2022-04-23,10 to 19,8029,153513,3,161545
2022-04-23,20 to 29,10388,162265,3,172656
2022-04-23,30 to 39,10763,148317,10,159090
2022-04-23,40 to 49,8931,115339,18,124288
2022-04-23,50 to 59,6915,75269,40,82224
2022-04-23,60 to 69,4544,40609,77,45230
2022-04-23,70 to 79,2219,16497,139,18855
2022-04-23,80 to 89,860,5911,198,6969
2022-04-23,90+,287,1330,146,1763
2022-04-23,Unknown,0,2,0,2
2022-04-23,Total,59381,824272,636,884289
2022-04-24,0 to 9,6187,106021,1,112209
2022-04-24,10 to 19,7891,154466,3,162360
2022-04-24,20 to 29,10337,163300,3,173640
2022-04-24,30 to 39,10562,149492,10,160064
2022-04-24,40 to 49,8876,116267,19,125162
2022-04-24,50 to 59,6998,75927,40,82965
2022-04-24,60 to 69,4610,41033,77,45720
2022-04-24,70 to 79,2219,16709,141,19069
2022-04-24,80 to 89,868,5992,203,7063
2022-04-24,90+,290,1348,147,1785
2022-04-24,Unknown,0,2,0,2
2022-04-24,Total,58838,830557,644,890039
2022-04-25,0 to 9,5834,106920,1,112755
2022-04-25,10 to 19,7505,155679,3,163187
2022-04-25,20 to 29,10058,164849,3,174910
2022-04-25,30 to 39,10260,151020,10,161290
2022-04-25,40 to 49,8605,117538,19,126162
2022-04-25,50 to 59,6909,76816,40,83765
2022-04-25,60 to 69,4501,41622,77,46200
2022-04-25,70 to 79,2154,16986,143,19283
2022-04-25,80 to 89,879,6056,204,7139
2022-04-25,90+,278,1375,149,1802
2022-04-25,Unknown,0,2,0,2
2022-04-25,Total,56983,838863,649,896495
2022-04-26,0 to 9,5421,108148,1,113570
2022-04-26,10 to 19,7228,157181,3,164412
2022-04-26,20 to 29,10059,166892,3,176954
2022-04-26,30 to 39,9766,153172,10,162948
2022-04-26,40 to 49,8355,119159,19,127533
2022-04-26,50 to 59,6913,78102,40,85055
2022-04-26,60 to 69,4488,42455,79,47022
2022-04-26,70 to 79,2170,17373,150,19693
2022-04-26,80 to 89,908,6218,211,7337
2022-04-26,90+,283,1433,155,1871
2022-04-26,Unknown,0,2,0,2
2022-04-26,Total,55591,850135,671,906397
2022-04-27,0 to 9,5072,109166,1,114239
2022-04-27,10 to 19,6966,158533,3,165502
2022-04-27,20 to 29,10111,168896,3,179010
2022-04-27,30 to 39,9380,155066,10,164456
2022-04-27,40 to 49,8074,120703,19,128796
2022-04-27,50 to 59,6891,79275,41,86207
2022-04-27,60 to 69,4464,43232,81,47777
2022-04-27,70 to 79,2205,17739,151,20095
2022-04-27,80 to 89,921,6376,214,7511
2022-04-27,90+,271,1496,160,1927
2022-04-27,Unknown,0,2,0,2
2022-04-27,Total,54355,860484,683,915522
2022-04-28,0 to 9,4760,110142,1,114903
2022-04-28,10 to 19,6752,159784,3,166539
2022-04-28,20 to 29,10163,170475,3,180641
2022-04-28,30 to 39,9135,156744,10,165889
2022-04-28,40 to 49,7817,122189,19,130025
2022-04-28,50 to 59,6821,80401,42,87264
2022-04-28,60 to 69,4399,43995,80,48474
2022-04-28,70 to 79,2220,18124,153,20497
2022-04-28,80 to 89,912,6523,221,7656
2022-04-28,90+,250,1543,164,1957
2022-04-28,Unknown,0,2,0,2
2022-04-28,Total,53229,869922,696,923847
2022-04-29,0 to 9,4539,111042,1,115582
2022-04-29,10 to 19,6615,160816,3,167434
2022-04-29,20 to 29,10198,171728,3,181929
2022-04-29,30 to 39,9002,158064,10,167076
2022-04-29,40 to 49,7595,123387,19,131001
2022-04-29,50 to 59,6718,81465,42,88225
2022-04-29,60 to 69,4316,44667,82,49065
2022-04-29,70 to 79,2240,18458,156,20854
2022-04-29,80 to 89,917,6665,222,7804
2022-04-29,90+,239,1594,164,1997
2022-04-29,Unknown,0,2,0,2
2022-04-29,Total,52379,877888,702,930969
2022-04-30,0 to 9,4498,111661,1,116160
2022-04-30,10 to 19,6601,161544,3,168148
2022-04-30,20 to 29,10349,172658,3,183010
2022-04-30,30 to 39,8883,159082,10,167975
2022-04-30,40 to 49,7540,124269,19,131828
2022-04-30,50 to 59,6760,82181,42,88983
2022-04-30,60 to 69,4318,45146,82,49546
2022-04-30,70 to 79,2280,18695,159,21134
2022-04-30,80 to 89,920,6749,224,7893
2022-04-30,90+,248,1606,164,2018
2022-04-30,Unknown,0,2,0,2
2022-04-30,Total,52397,883593,707,936697
2022-05-01,0 to 9,4552,112203,1,116756
2022-05-01,10 to 19,6712,162357,3,169072
2022-05-01,20 to 29,10585,173636,3,184224
2022-05-01,30 to 39,9000,160052,10,169062
2022-05-01,40 to 49,7658,125138,20,132816
2022-05-01,50 to 59,6963,82923,43,89929
2022-05-01,60 to 69,4374,45634,82,50090
2022-05-01,70 to 79,2340,18909,159,21408
2022-05-01,80 to 89,954,6841,226,8021
2022-05-01,90+,257,1625,166,2048
2022-05-01,Unknown,0,2,0,2
2022-05-01,Total,53395,889320,713,943428
2022-05-02,0 to 9,4763,112749,1,117513
2022-05-02,10 to 19,7064,163181,3,170248
2022-05-02,20 to 29,11072,174902,3,185977
2022-05-02,30 to 39,9330,161283,10,170623
2022-05-02,40 to 49,7969,126142,20,134131
2022-05-02,50 to 59,7397,83728,44,91169
2022-05-02,60 to 69,4688,46113,84,50885
2022-05-02,70 to 79,2565,19120,162,21847
2022-05-02,80 to 89,1065,6911,234,8210
2022-05-02,90+,281,1641,170,2092
2022-05-02,Unknown,0,2,0,2
2022-05-02,Total,56194,895772,731,952697
2022-05-03,0 to 9,4563,113569,2,118134
2022-05-03,10 to 19,6908,164407,4,171319
2022-05-03,20 to 29,10793,176953,3,187749
2022-05-03,30 to 39,9104,162935,10,172049
2022-05-03,40 to 49,7779,127508,22,135309
2022-05-03,50 to 59,7247,85008,45,92300
2022-05-03,60 to 69,4612,46933,86,51631
2022-05-03,70 to 79,2552,19525,169,22246
2022-05-03,80 to 89,1047,7102,239,8388
2022-05-03,90+,259,1703,173,2135
2022-05-03,Unknown,0,2,0,2
2022-05-03,Total,54864,905645,753,961262
2022-05-04,0 to 9,4500,114236,3,118739
2022-05-04,10 to 19,6845,165499,4,172348
2022-05-04,20 to 29,10607,179003,3,189613
2022-05-04,30 to 39,9067,164440,10,173517
2022-05-04,40 to 49,7680,128767,23,136470
2022-05-04,50 to 59,7256,86160,45,93461
2022-05-04,60 to 69,4665,47686,91,52442
2022-05-04,70 to 79,2564,19924,171,22659
2022-05-04,80 to 89,1028,7270,247,8545
2022-05-04,90+,232,1754,177,2163
2022-05-04,Unknown,0,2,0,2
2022-05-04,Total,54444,914741,774,969959
2022-05-05,0 to 9,4469,114898,3,119370
2022-05-05,10 to 19,6691,166536,4,173231
2022-05-05,20 to 29,10399,180633,3,191035
2022-05-05,30 to 39,8863,165872,10,174745
2022-05-05,40 to 49,7468,129992,25,137485
2022-05-05,50 to 59,7198,87217,46,94461
2022-05-05,60 to 69,4670,48383,92,53145
2022-05-05,70 to 79,2525,20320,178,23023
2022-05-05,80 to 89,1023,7404,254,8681
2022-05-05,90+,241,1779,182,2202
2022-05-05,Unknown,0,2,0,2
2022-05-05,Total,53547,923036,797,977380
2022-05-06,0 to 9,4416,115577,3,119996
2022-05-06,10 to 19,6692,167431,4,174127
2022-05-06,20 to 29,10361,181921,3,192285
2022-05-06,30 to 39,8726,167061,10,175797
2022-05-06,40 to 49,7409,130966,25,138400
2022-05-06,50 to 59,7145,88179,46,95370
2022-05-06,60 to 69,4727,48975,93,53795
2022-05-06,70 to 79,2523,20677,180,23380
2022-05-06,80 to 89,1018,7549,258,8825
2022-05-06,90+,238,1817,186,2241
2022-05-06,Unknown,0,2,0,2
2022-05-06,Total,53255,930155,808,984218
2022-05-07,0 to 9,4368,116155,3,120526
2022-05-07,10 to 19,6710,168144,4,174858
2022-05-07,20 to 29,10302,183004,3,193309
2022-05-07,30 to 39,8825,167961,10,176796
2022-05-07,40 to 49,7394,131794,25,139213
2022-05-07,50 to 59,7157,88935,47,96139
2022-05-07,60 to 69,4736,49454,93,54283
2022-05-07,70 to 79,2490,20955,180,23625
2022-05-07,80 to 89,1035,7638,259,8932
2022-05-07,90+,239,1838,186,2263
2022-05-07,Unknown,0,2,0,2
2022-05-07,Total,53256,935880,810,989946
2022-05-08,0 to 9,4338,116751,3,121092
2022-05-08,10 to 19,6802,169067,4,175873
2022-05-08,20 to 29,10202,184218,3,194423
2022-05-08,30 to 39,8808,169049,10,177867
2022-05-08,40 to 49,7327,132781,25,140133
2022-05-08,50 to 59,7102,89880,47,97029
2022-05-08,60 to 69,4716,49998,93,54807
2022-05-08,70 to 79,2483,21228,180,23891
2022-05-08,80 to 89,997,7764,261,9022
2022-05-08,90+,224,1868,186,2278
2022-05-08,Unknown,0,2,0,2
2022-05-08,Total,52999,942606,812,996417
2022-05-09,0 to 9,4783,117238,3,122024
2022-05-09,10 to 19,7383,169803,4,177190
2022-05-09,20 to 29,10723,185320,3,196046
2022-05-09,30 to 39,9289,170061,10,179360
2022-05-09,40 to 49,7756,133685,25,141466
2022-05-09,50 to 59,7413,90745,47,98205
2022-05-09,60 to 69,4948,50534,93,55575
2022-05-09,70 to 79,2576,21538,186,24300
2022-05-09,80 to 89,1035,7887,264,9186
2022-05-09,90+,225,1904,191,2320
2022-05-09,Unknown,0,2,0,2
2022-05-09,Total,56131,948717,826,1005674
2022-05-10,0 to 9,4615,118127,3,122745
2022-05-10,10 to 19,6992,171315,4,178311
2022-05-10,20 to 29,9798,187738,3,197539
2022-05-10,30 to 39,8591,172034,10,180635
2022-05-10,40 to 49,7346,135277,26,142649
2022-05-10,50 to 59,6950,92251,48,99249
2022-05-10,60 to 69,4622,51529,95,56246
2022-05-10,70 to 79,2416,22055,194,24665
2022-05-10,80 to 89,940,8113,276,9329
2022-05-10,90+,212,1943,196,2351
2022-05-10,Unknown,0,2,0,2
2022-05-10,Total,52482,960384,855,1013721
2022-05-11,0 to 9,4748,118732,3,123483
2022-05-11,10 to 19,7243,172345,4,179592
2022-05-11,20 to 29,9747,189605,3,199355
2022-05-11,30 to 39,8752,173506,10,182268
2022-05-11,40 to 49,7605,136437,26,144068
2022-05-11,50 to 59,7024,93411,48,100483
2022-05-11,60 to 69,4569,52341,95,57005
2022-05-11,70 to 79,2415,22466,195,25076
2022-05-11,80 to 89,935,8269,277,9481
2022-05-11,90+,225,1965,202,2392
2022-05-11,Unknown,0,2,0,2
2022-05-11,Total,53263,969079,863,1023205
2022-05-12,0 to 9,4809,119366,3,124178
2022-05-12,10 to 19,7413,173225,4,180642
2022-05-12,20 to 29,9568,191029,5,200602
2022-05-12,30 to 39,8738,174733,13,183484
2022-05-12,40 to 49,7756,137454,26,145236
2022-05-12,50 to 59,6997,94404,51,101452
2022-05-12,60 to 69,4487,53043,99,57629
2022-05-12,70 to 79,2420,22826,201,25447
2022-05-12,80 to 89,953,8406,280,9639
2022-05-12,90+,217,1995,210,2422
2022-05-12,Unknown,0,2,0,2
2022-05-12,Total,53358,976483,892,1030733
2022-05-13,0 to 9,4867,119992,3,124862
2022-05-13,10 to 19,7579,174118,4,181701
2022-05-13,20 to 29,9348,192276,5,201629
2022-05-13,30 to 39,8843,175778,13,184634
2022-05-13,40 to 49,7925,138367,26,146318
2022-05-13,50 to 59,7018,95311,52,102381
2022-05-13,60 to 69,4509,53690,100,58299
2022-05-13,70 to 79,2401,23177,205,25783
2022-05-13,80 to 89,961,8543,286,9790
2022-05-13,90+,209,2032,215,2456
2022-05-13,Unknown,0,2,0,2
2022-05-13,Total,53660,983286,909,1037855
2022-05-14,0 to 9,4856,120521,3,125380
2022-05-14,10 to 19,7767,174849,4,182620
2022-05-14,20 to 29,9155,193302,5,202462
2022-05-14,30 to 39,8792,176779,13,185584
2022-05-14,40 to 49,8084,139181,26,147291
2022-05-14,50 to 59,7033,96078,54,103165
2022-05-14,60 to 69,4519,54177,101,58797
2022-05-14,70 to 79,2393,23420,206,26019
2022-05-14,80 to 89,949,8645,293,9887
2022-05-14,90+,207,2051,218,2476
2022-05-14,Unknown,0,2,0,2
2022-05-14,Total,53755,989005,923,1043683
2022-05-15,0 to 9,4903,121088,3,125994
2022-05-15,10 to 19,7875,175864,4,183743
2022-05-15,20 to 29,9066,194416,5,203487
2022-05-15,30 to 39,8913,177850,13,186776
2022-05-15,40 to 49,8314,140100,26,148440
2022-05-15,50 to 59,7134,96967,55,104156
2022-05-15,60 to 69,4604,54701,101,59406
2022-05-15,70 to 79,2413,23686,207,26306
2022-05-15,80 to 89,964,8734,294,9992
2022-05-15,90+,211,2063,221,2495
2022-05-15,Unknown,0,2,0,2
2022-05-15,Total,54397,995471,929,1050797
2022-05-16,0 to 9,4856,122021,3,126880
2022-05-16,10 to 19,8102,177181,4,185287
2022-05-16,20 to 29,8944,196040,5,204989
2022-05-16,30 to 39,9007,179348,13,188368
2022-05-16,40 to 49,8467,141435,26,149928
2022-05-16,50 to 59,7250,98148,55,105453
2022-05-16,60 to 69,4715,55468,102,60285
2022-05-16,70 to 79,2487,24092,211,26790
2022-05-16,80 to 89,1009,8894,294,10197
2022-05-16,90+,205,2102,224,2531
2022-05-16,Unknown,0,2,0,2
2022-05-16,Total,55042,1004731,937,1060710
2022-05-17,0 to 9,4971,122742,3,127716
2022-05-17,10 to 19,8373,178302,4,186679
2022-05-17,20 to 29,9012,197533,6,206551
2022-05-17,30 to 39,9254,180622,13,189889
2022-05-17,40 to 49,8827,142611,30,151468
2022-05-17,50 to 59,7471,99192,57,106720
2022-05-17,60 to 69,4852,56138,105,61095
2022-05-17,70 to 79,2597,24448,219,27264
2022-05-17,80 to 89,1063,9032,303,10398
2022-05-17,90+,232,2132,227,2591
2022-05-17,Unknown,0,2,0,2
2022-05-17,Total,56652,1012754,967,1070373
2022-05-18,0 to 9,4905,123480,3,128388
2022-05-18,10 to 19,8353,179580,4,187937
2022-05-18,20 to 29,8600,199349,6,207955
2022-05-18,30 to 39,9208,182253,13,191474
2022-05-18,40 to 49,8833,144031,30,152894
2022-05-18,50 to 59,7482,100426,57,107965
2022-05-18,60 to 69,4916,56898,106,61920
2022-05-18,70 to 79,2676,24856,220,27752
2022-05-18,80 to 89,1142,9177,307,10626
2022-05-18,90+,246,2171,227,2644
2022-05-18,Unknown,0,2,0,2
2022-05-18,Total,56361,1022223,973,1079557
2022-05-19,0 to 9,4840,124174,3,129017
2022-05-19,10 to 19,8393,180633,4,189030
2022-05-19,20 to 29,8473,200595,6,209074
2022-05-19,30 to 39,9269,183470,13,192752
2022-05-19,40 to 49,8960,145206,29,154195
2022-05-19,50 to 59,7620,101391,58,109069
2022-05-19,60 to 69,4990,57521,106,62617
2022-05-19,70 to 79,2734,25224,224,28182
2022-05-19,80 to 89,1181,9333,312,10826
2022-05-19,90+,274,2193,235,2702
2022-05-19,Unknown,0,2,0,2
2022-05-19,Total,56734,1029742,990,1087466
2022-05-20,0 to 9,4765,124857,3,129625
2022-05-20,10 to 19,8368,181694,4,190066
2022-05-20,20 to 29,8336,201624,6,209966
2022-05-20,30 to 39,9109,184619,13,193741
2022-05-20,40 to 49,8954,146286,29,155269
2022-05-20,50 to 59,7621,102321,58,110000
2022-05-20,60 to 69,4879,58191,107,63177
2022-05-20,70 to 79,2779,25560,226,28565
2022-05-20,80 to 89,1226,9481,315,11022
2022-05-20,90+,298,2225,236,2759
2022-05-20,Unknown,0,2,0,2
2022-05-20,Total,56335,1036860,997,1094192
2022-05-21,0 to 9,4668,125376,3,130047
2022-05-21,10 to 19,8226,182613,4,190843
2022-05-21,20 to 29,8225,202457,6,210688
2022-05-21,30 to 39,8932,185569,13,194514
2022-05-21,40 to 49,8808,147258,29,156095
2022-05-21,50 to 59,7566,103106,58,110730
2022-05-21,60 to 69,4842,58687,108,63637
2022-05-21,70 to 79,2794,25796,228,28818
2022-05-21,80 to 89,1208,9571,320,11099
2022-05-21,90+,296,2243,238,2777
2022-05-21,Unknown,0,2,0,2
2022-05-21,Total,55565,1042678,1007,1099250
2022-05-22,0 to 9,4631,125989,3,130623
2022-05-22,10 to 19,8124,183736,4,191864
2022-05-22,20 to 29,8014,203483,6,211503
2022-05-22,30 to 39,8697,186761,14,195472
2022-05-22,40 to 49,8655,148408,29,157092
2022-05-22,50 to 59,7429,104096,58,111583
2022-05-22,60 to 69,4737,59297,108,64142
2022-05-22,70 to 79,2731,26081,228,29040
2022-05-22,80 to 89,1197,9673,324,11194
2022-05-22,90+,302,2257,243,2802
2022-05-22,Unknown,0,2,0,2
2022-05-22,Total,54517,1049783,1017,1105317
2022-05-23,0 to 9,4520,126876,3,131399
2022-05-23,10 to 19,7956,185280,4,193240
2022-05-23,20 to 29,7671,204983,6,212660
2022-05-23,30 to 39,8376,188355,14,196745
2022-05-23,40 to 49,8554,149900,30,158484
2022-05-23,50 to 59,7247,105393,58,112698
2022-05-23,60 to 69,4633,60180,109,64922
2022-05-23,70 to 79,2654,26566,229,29449
2022-05-23,80 to 89,1164,9885,327,11376
2022-05-23,90+,308,2294,251,2853
2022-05-23,Unknown,0,2,0,2
2022-05-23,Total,53083,1059714,1031,1113828
2022-05-24,0 to 9,4386,127712,4,132102
2022-05-24,10 to 19,7731,186673,4,194408
2022-05-24,20 to 29,7268,206544,6,213818
2022-05-24,30 to 39,8215,189875,14,198104
2022-05-24,40 to 49,8355,151440,30,159825
2022-05-24,50 to 59,7078,106659,58,113795
2022-05-24,60 to 69,4589,60989,110,65688
2022-05-24,70 to 79,2609,27039,230,29878
2022-05-24,80 to 89,1158,10079,330,11567
2022-05-24,90+,290,2343,255,2888
2022-05-24,Unknown,0,2,0,2
2022-05-24,Total,51679,1069355,1041,1122075
2022-05-25,0 to 9,4332,128383,4,132719
2022-05-25,10 to 19,7508,187933,4,195445
2022-05-25,20 to 29,7010,207949,6,214965
2022-05-25,30 to 39,7897,191462,14,199373
2022-05-25,40 to 49,8192,152864,30,161086
2022-05-25,50 to 59,6914,107904,58,114876
2022-05-25,60 to 69,4442,61811,112,66365
2022-05-25,70 to 79,2521,27524,232,30277
2022-05-25,80 to 89,1080,10300,338,11718
2022-05-25,90+,275,2389,259,2923
2022-05-25,Unknown,0,2,0,2
2022-05-25,Total,50171,1078521,1057,1129749
2022-05-26,0 to 9,4227,129013,4,133244
2022-05-26,10 to 19,7352,189026,4,196382
2022-05-26,20 to 29,6868,209066,6,215940
2022-05-26,30 to 39,7808,192736,15,200559
2022-05-26,40 to 49,8022,154162,34,162218
2022-05-26,50 to 59,6811,109001,62,115874
2022-05-26,60 to 69,4410,62505,114,67029
2022-05-26,70 to 79,2433,27951,237,30621
2022-05-26,80 to 89,1042,10490,344,11876
2022-05-26,90+,256,2440,267,2963
2022-05-26,Unknown,0,2,0,2
2022-05-26,Total,49229,1086392,1087,1136708
2022-05-27,0 to 9,4198,129623,4,133825
2022-05-27,10 to 19,7207,190060,4,197271
2022-05-27,20 to 29,6819,209955,7,216781
2022-05-27,30 to 39,7834,193725,15,201574
2022-05-27,40 to 49,8042,155236,33,163311
2022-05-27,50 to 59,6721,109931,62,116714
2022-05-27,60 to 69,4475,63065,116,67656
2022-05-27,70 to 79,2416,28333,241,30990
2022-05-27,80 to 89,997,10681,347,12025
2022-05-27,90+,237,2491,269,2997
2022-05-27,Unknown,0,2,0,2
2022-05-27,Total,48946,1093102,1098,1143146
2022-05-28,0 to 9,4180,130045,4,134229
2022-05-28,10 to 19,7139,190837,4,197980
2022-05-28,20 to 29,6713,210677,7,217397
2022-05-28,30 to 39,7878,194498,15,202391
2022-05-28,40 to 49,8004,156061,34,164099
2022-05-28,50 to 59,6687,110660,62,117409
2022-05-28,60 to 69,4518,63524,117,68159
2022-05-28,70 to 79,2438,28579,245,31262
2022-05-28,80 to 89,992,10756,350,12098
2022-05-28,90+,237,2513,269,3019
2022-05-28,Unknown,0,2,0,2
2022-05-28,Total,48786,1098152,1107,1148045
2022-05-29,0 to 9,4118,130621,4,134743
2022-05-29,10 to 19,6976,191858,4,198838
2022-05-29,20 to 29,6650,211492,7,218149
2022-05-29,30 to 39,7884,195456,15,203355
2022-05-29,40 to 49,8004,157057,34,165095
2022-05-29,50 to 59,6697,111514,62,118273
2022-05-29,60 to 69,4575,64028,117,68720
2022-05-29,70 to 79,2499,28800,246,31545
2022-05-29,80 to 89,979,10849,353,12181
2022-05-29,90+,238,2537,270,3045
2022-05-29,Unknown,0,2,0,2
2022-05-29,Total,48620,1104214,1112,1153946
2022-05-30,0 to 9,4078,131397,4,135479
2022-05-30,10 to 19,6817,193234,4,200055
2022-05-30,20 to 29,6633,212649,7,219289
2022-05-30,30 to 39,8034,196729,15,204778
2022-05-30,40 to 49,7953,158449,33,166435
2022-05-30,50 to 59,6705,112628,63,119396
2022-05-30,60 to 69,4666,64806,118,69590
2022-05-30,70 to 79,2526,29208,248,31982
2022-05-30,80 to 89,1006,11019,360,12385
2022-05-30,90+,252,2580,276,3108
2022-05-30,Unknown,0,2,0,2
2022-05-30,Total,48670,1112701,1128,1162499
2022-05-31,0 to 9,4048,132099,4,136151
2022-05-31,10 to 19,6730,194403,4,201137
2022-05-31,20 to 29,6633,213808,7,220448
2022-05-31,30 to 39,8081,198088,15,206184
2022-05-31,40 to 49,7933,159789,34,167756
2022-05-31,50 to 59,6815,113727,63,120605
2022-05-31,60 to 69,4693,65568,118,70379
2022-05-31,70 to 79,2559,29632,250,32441
2022-05-31,80 to 89,991,11207,365,12563
2022-05-31,90+,256,2613,280,3149
2022-05-31,Unknown,0,2,0,2
2022-05-31,Total,48739,1120936,1140,1170815
2022-06-01,0 to 9,4015,132716,4,136735
2022-06-01,10 to 19,6528,195438,4,201970
2022-06-01,20 to 29,6613,214958,7,221578
2022-06-01,30 to 39,8120,199357,15,207492
2022-06-01,40 to 49,7961,161049,35,169045
2022-06-01,50 to 59,6934,114811,63,121808
2022-06-01,60 to 69,4877,66243,120,71240
2022-06-01,70 to 79,2677,30027,251,32955
2022-06-01,80 to 89,1056,11353,371,12780
2022-06-01,90+,283,2647,281,3211
2022-06-01,Unknown,0,2,0,2
2022-06-01,Total,49064,1128601,1151,1178816
2022-06-02,0 to 9,4024,133240,4,137268
2022-06-02,10 to 19,6363,196375,4,202742
2022-06-02,20 to 29,6398,215937,7,222342
2022-06-02,30 to 39,7971,200543,15,208529
2022-06-02,40 to 49,7887,162179,35,170101
2022-06-02,50 to 59,6843,115812,63,122718
2022-06-02,60 to 69,4876,66905,122,71903
2022-06-02,70 to 79,2722,30368,253,33343
2022-06-02,80 to 89,1071,11508,374,12953
2022-06-02,90+,279,2685,286,3250
2022-06-02,Unknown,0,2,0,2
2022-06-02,Total,48434,1135554,1163,1185151
2022-06-03,0 to 9,3950,133821,4,137775
2022-06-03,10 to 19,6253,197264,4,203521
2022-06-03,20 to 29,6292,216784,7,223083
2022-06-03,30 to 39,8022,201559,15,209596
2022-06-03,40 to 49,7872,163274,34,171180
2022-06-03,50 to 59,6895,116654,63,123612
2022-06-03,60 to 69,4922,67532,122,72576
2022-06-03,70 to 79,2788,30735,256,33779
2022-06-03,80 to 89,1111,11652,377,13140
2022-06-03,90+,287,2719,290,3296
2022-06-03,Unknown,0,2,0,2
2022-06-03,Total,48392,1141996,1172,1191560
2022-06-04,0 to 9,3932,134228,4,138164
2022-06-04,10 to 19,6092,197972,4,204068
2022-06-04,20 to 29,6228,217399,7,223634
2022-06-04,30 to 39,7961,202375,15,210351
2022-06-04,40 to 49,7787,164062,34,171883
2022-06-04,50 to 59,6863,117348,63,124274
2022-06-04,60 to 69,4880,68034,122,73036
2022-06-04,70 to 79,2789,31007,258,34054
2022-06-04,80 to 89,1139,11724,379,13242
2022-06-04,90+,294,2738,293,3325
2022-06-04,Unknown,0,2,0,2
2022-06-04,Total,47965,1146889,1179,1196033
2022-06-06,0 to 9,3643,135475,4,139122
2022-06-06,10 to 19,5322,200047,4,205373
2022-06-06,20 to 29,5666,219286,7,224959
2022-06-06,30 to 39,7289,204760,15,212064
2022-06-06,40 to 49,7234,166398,35,173667
2022-06-06,50 to 59,6372,119330,65,125767
2022-06-06,60 to 69,4457,69465,123,74045
2022-06-06,70 to 79,2626,31722,262,34610
2022-06-06,80 to 89,1049,12007,384,13440
2022-06-06,90+,245,2822,295,3362
2022-06-06,Unknown,0,2,0,2
2022-06-06,Total,43903,1161314,1194,1206411
2022-06-07,0 to 9,3555,136147,4,139706
2022-06-07,10 to 19,5110,201130,4,206244
2022-06-07,20 to 29,5403,220447,7,225857
2022-06-07,30 to 39,7036,206167,15,213218
2022-06-07,40 to 49,7005,167719,35,174759
2022-06-07,50 to 59,6204,120537,68,126809
2022-06-07,60 to 69,4403,70252,125,74780
2022-06-07,70 to 79,2638,32177,265,35080
2022-06-07,80 to 89,1084,12178,391,13653
2022-06-07,90+,281,2855,302,3438
2022-06-07,Unknown,0,2,0,2
2022-06-07,Total,42719,1169611,1216,1213546
2022-06-08,0 to 9,3662,136730,4,140396
2022-06-08,10 to 19,5131,201965,4,207100
2022-06-08,20 to 29,5498,221578,7,227083
2022-06-08,30 to 39,7043,207477,15,214535
2022-06-08,40 to 49,7043,169008,36,176087
2022-06-08,50 to 59,6203,121738,68,128009
2022-06-08,60 to 69,4413,71113,126,75652
2022-06-08,70 to 79,2600,32687,272,35559
2022-06-08,80 to 89,1028,12389,400,13817
2022-06-08,90+,264,2912,308,3484
2022-06-08,Unknown,0,2,0,2
2022-06-08,Total,42885,1177599,1240,1221724
2022-06-09,0 to 9,3636,137264,4,140904
2022-06-09,10 to 19,5079,202739,4,207822
2022-06-09,20 to 29,5566,222335,7,227908
2022-06-09,30 to 39,7084,208512,15,215611
2022-06-09,40 to 49,7070,170066,36,177172
2022-06-09,50 to 59,6254,122646,68,128968
2022-06-09,60 to 69,4428,71776,126,76330
2022-06-09,70 to 79,2616,33074,272,35962
2022-06-09,80 to 89,1017,12561,403,13981
2022-06-09,90+,268,2947,312,3527
2022-06-09,Unknown,0,2,0,2
2022-06-09,Total,43018,1183922,1247,1228187
2022-06-10,0 to 9,3542,137770,4,141316
2022-06-10,10 to 19,4828,203517,4,208349
2022-06-10,20 to 29,5588,223072,7,228667
2022-06-10,30 to 39,6877,209580,15,216472
2022-06-10,40 to 49,6817,171145,36,177998
2022-06-10,50 to 59,6138,123543,68,129749
2022-06-10,60 to 69,4339,72448,127,76914
2022-06-10,70 to 79,2502,33508,275,36285
2022-06-10,80 to 89,996,12739,404,14139
2022-06-10,90+,257,2988,314,3559
2022-06-10,Unknown,0,2,0,2
2022-06-10,Total,41884,1190312,1254,1233450
2022-06-11,0 to 9,3533,138159,4,141696
2022-06-11,10 to 19,4771,204064,4,208839
2022-06-11,20 to 29,5606,223623,7,229236
2022-06-11,30 to 39,6849,210335,15,217199
2022-06-11,40 to 49,6785,171849,35,178669
2022-06-11,50 to 59,6130,124205,68,130403
2022-06-11,60 to 69,4415,72908,127,77450
2022-06-11,70 to 79,2540,33783,278,36601
2022-06-11,80 to 89,1048,12839,408,14295
2022-06-11,90+,257,3017,315,3589
2022-06-11,Unknown,0,2,0,2
2022-06-11,Total,41934,1194784,1261,1237979
2022-06-12,0 to 9,3425,138612,4,142041
2022-06-12,10 to 19,4736,204618,4,209358
2022-06-12,20 to 29,5709,224159,7,229875
2022-06-12,30 to 39,6878,211043,15,217936
2022-06-12,40 to 49,6727,172623,36,179386
2022-06-12,50 to 59,6178,124867,68,131113
2022-06-12,60 to 69,4474,73338,128,77940
2022-06-12,70 to 79,2531,34039,280,36850
2022-06-12,80 to 89,1054,12924,409,14387
2022-06-12,90+,252,3041,316,3609
2022-06-12,Unknown,0,2,0,2
2022-06-12,Total,41964,1199266,1267,1242497
2022-06-13,0 to 9,3471,139117,4,142592
2022-06-13,10 to 19,4669,205367,4,210040
2022-06-13,20 to 29,5836,224948,7,230791
2022-06-13,30 to 39,6983,212048,15,219046
2022-06-13,40 to 49,6674,173632,35,180341
2022-06-13,50 to 59,6233,125697,68,131998
2022-06-13,60 to 69,4531,73916,128,78575
2022-06-13,70 to 79,2612,34334,282,37228
2022-06-13,80 to 89,1118,13033,419,14570
2022-06-13,90+,295,3050,324,3669
2022-06-13,Unknown,0,2,0,2
2022-06-13,Total,42422,1205144,1286,1248852
2022-06-14,0 to 9,3320,139763,4,143087
2022-06-14,10 to 19,4385,206226,4,210615
2022-06-14,20 to 29,5744,225895,7,231646
2022-06-14,30 to 39,6785,213197,15,219997
2022-06-14,40 to 49,6449,174735,35,181219
2022-06-14,50 to 59,5971,126747,68,132786
2022-06-14,60 to 69,4422,74628,130,79180
2022-06-14,70 to 79,2514,34791,285,37590
2022-06-14,80 to 89,1077,13237,420,14734
2022-06-14,90+,258,3119,327,3704
2022-06-14,Unknown,0,2,0,2
2022-06-14,Total,40925,1212340,1295,1254560
2022-06-15,0 to 9,3156,140392,4,143552
2022-06-15,10 to 19,4103,207095,4,211202
2022-06-15,20 to 29,5363,227072,7,232442
2022-06-15,30 to 39,6483,214519,15,221017
2022-06-15,40 to 49,6047,176049,36,182132
2022-06-15,50 to 59,5637,127940,69,133646
2022-06-15,60 to 69,4213,75522,131,79866
2022-06-15,70 to 79,2391,35275,286,37952
2022-06-15,80 to 89,1056,13396,426,14878
2022-06-15,90+,259,3163,330,3752
2022-06-15,Unknown,0,2,0,2
2022-06-15,Total,38708,1220425,1308,1260441
2022-06-16,0 to 9,3098,140900,4,144002
2022-06-16,10 to 19,3855,207817,4,211676
2022-06-16,20 to 29,5256,227899,7,233162
2022-06-16,30 to 39,6273,215596,15,221884
2022-06-16,40 to 49,5687,177134,35,182856
2022-06-16,50 to 59,5425,128897,69,134391
2022-06-16,60 to 69,4068,76197,131,80396
2022-06-16,70 to 79,2311,35678,287,38276
2022-06-16,80 to 89,1033,13553,433,15019
2022-06-16,90+,256,3205,330,3791
2022-06-16,Unknown,0,2,0,2
2022-06-16,Total,37262,1226878,1315,1265455
2022-06-17,0 to 9,3105,141312,4,144421
2022-06-17,10 to 19,3767,208345,4,212116
2022-06-17,20 to 29,5105,228658,7,233770
2022-06-17,30 to 39,6185,216457,15,222657
2022-06-17,40 to 49,5521,177956,36,183513
2022-06-17,50 to 59,5286,129677,69,135032
2022-06-17,60 to 69,4028,76778,131,80937
2022-06-17,70 to 79,2287,35998,291,38576
2022-06-17,80 to 89,1030,13712,434,15176
2022-06-17,90+,275,3231,333,3839
2022-06-17,Unknown,0,2,0,2
2022-06-17,Total,36589,1232126,1324,1270039
2022-06-18,0 to 9,3013,141692,4,144709
2022-06-18,10 to 19,3611,208836,4,212451
2022-06-18,20 to 29,4975,229226,7,234208
2022-06-18,30 to 39,6080,217183,15,223278
2022-06-18,40 to 49,5363,178627,36,184026
2022-06-18,50 to 59,5109,130330,69,135508
2022-06-18,60 to 69,3888,77313,133,81334
2022-06-18,70 to 79,2164,36313,291,38768
2022-06-18,80 to 89,953,13864,434,15251
2022-06-18,90+,262,3256,336,3854
2022-06-18,Unknown,0,2,0,2
2022-06-18,Total,35418,1236642,1329,1273389
2022-06-19,0 to 9,2999,142050,4,145053
2022-06-19,10 to 19,3562,209355,4,212921
2022-06-19,20 to 29,4881,229888,7,234776
2022-06-19,30 to 39,6023,217927,15,223965
2022-06-19,40 to 49,5316,179347,37,184700
2022-06-19,50 to 59,5047,131041,69,136157
2022-06-19,60 to 69,3829,77792,134,81755
2022-06-19,70 to 79,2170,36556,292,39018
2022-06-19,80 to 89,949,13958,438,15345
2022-06-19,90+,264,3275,337,3876
2022-06-19,Unknown,0,2,0,2
2022-06-19,Total,35040,1241191,1337,1277568
2022-06-20,0 to 9,2951,142588,5,145544
2022-06-20,10 to 19,3498,210038,4,213540
2022-06-20,20 to 29,4769,230782,7,235558
2022-06-20,30 to 39,5881,219028,15,224924
2022-06-20,40 to 49,5311,180302,37,185650
2022-06-20,50 to 59,4969,131925,70,136964
2022-06-20,60 to 69,3816,78436,135,82387
2022-06-20,70 to 79,2175,36934,294,39403
2022-06-20,80 to 89,969,14135,445,15549
2022-06-20,90+,252,3333,338,3923
2022-06-20,Unknown,0,2,0,2
2022-06-20,Total,34591,1247503,1350,1283444
2022-06-21,0 to 9,2865,143084,5,145954
2022-06-21,10 to 19,3479,210611,4,214094
2022-06-21,20 to 29,4694,231636,7,236337
2022-06-21,30 to 39,5938,219983,15,225936
2022-06-21,40 to 49,5301,181180,37,186518
2022-06-21,50 to 59,5004,132711,71,137786
2022-06-21,60 to 69,3793,79039,136,82968
2022-06-21,70 to 79,2190,37294,297,39781
2022-06-21,80 to 89,1006,14292,453,15751
2022-06-21,90+,295,3363,343,4001
2022-06-21,Unknown,0,2,0,2
2022-06-21,Total,34565,1253195,1368,1289128
2022-06-22,0 to 9,2841,143562,5,146408
2022-06-22,10 to 19,3372,211205,4,214581
2022-06-22,20 to 29,4593,232450,7,237050
2022-06-22,30 to 39,5864,221002,15,226881
2022-06-22,40 to 49,5311,182090,37,187438
2022-06-22,50 to 59,5003,133574,73,138650
2022-06-22,60 to 69,3705,79720,136,83561
2022-06-22,70 to 79,2198,37653,297,40148
2022-06-22,80 to 89,1024,14425,460,15909
2022-06-22,90+,273,3410,346,4029
2022-06-22,Unknown,0,2,0,2
2022-06-22,Total,34184,1259093,1380,1294657
2022-06-24,0 to 9,2714,144416,5,147135
2022-06-24,10 to 19,3372,212112,4,215488
2022-06-24,20 to 29,4414,233759,7,238180
2022-06-24,30 to 39,5786,222642,15,228443
2022-06-24,40 to 49,5292,183475,37,188804
2022-06-24,50 to 59,5007,134959,74,140040
2022-06-24,60 to 69,3674,80801,137,84612
2022-06-24,70 to 79,2203,38273,301,40777
2022-06-24,80 to 89,1006,14719,471,16196
2022-06-24,90+,262,3487,353,4102
2022-06-24,Unknown,0,2,0,2
2022-06-24,Total,33730,1268645,1404,1303779
2022-06-25,0 to 9,2800,144703,5,147508
2022-06-25,10 to 19,3456,212444,4,215904
2022-06-25,20 to 29,4574,234201,7,238782
2022-06-25,30 to 39,5956,223261,15,229232
2022-06-25,40 to 49,5521,183988,37,189546
2022-06-25,50 to 59,5204,135433,75,140712
2022-06-25,60 to 69,3814,81198,138,85150
2022-06-25,70 to 79,2318,38462,303,41083
2022-06-25,80 to 89,1075,14793,471,16339
2022-06-25,90+,273,3501,355,4129
2022-06-25,Unknown,0,2,0,2
2022-06-25,Total,34991,1271986,1410,1308387
2022-06-26,0 to 9,2877,145047,5,147929
2022-06-26,10 to 19,3558,212915,4,216477
2022-06-26,20 to 29,4742,234767,7,239516
2022-06-26,30 to 39,6201,223947,15,230163
2022-06-26,40 to 49,5840,184661,37,190538
2022-06-26,50 to 59,5490,136081,75,141646
2022-06-26,60 to 69,4054,81616,140,85810
2022-06-26,70 to 79,2421,38713,305,41439
2022-06-26,80 to 89,1111,14882,474,16467
2022-06-26,90+,275,3524,359,4158
2022-06-26,Unknown,0,2,0,2
2022-06-26,Total,36569,1276155,1421,1314145
